NACE 2 CODE,Activity Code,Economic Activity,Year,Month,Anastoles-Metapoiisi,Anastoles-Touristiki,Termatismoi-Touristiki,Termatismoi-Alloi,Total
A,1,"Γεωργία, δασοκομία και αλιεία",2013,Ιανουάριος,0,0,0,159,159
B,2,Ορυχεία και λατομεία,2013,Ιανουάριος,0,0,0,62,62
C,3,Μεταποίηση,2013,Ιανουάριος,141,0,0,2690,2831
D,4,"Παροχή ηλεκτρικού ρεύματος, φυσικού αερίου, ατμού και κλιματισμού",2013,Ιανουάριος,0,0,0,15,15
E,5,"Παροχή νερού, επεξεργασία λυμάτων, διαχείριση αποβλήτων και δραστηριότητες εξυγίανσης",2013,Ιανουάριος,0,0,0,31,31
F,6,Κατασκευές,2013,Ιανουάριος,0,5,10,4790,4805
G,7,Χονδρικό και λιανικό εμπόριο.  Επισκευή μηχανοκίνητων οχημάτων και μοτοσυκλετών,2013,Ιανουάριος,0,242,20,5524,5786
H,8,Μεταφορά και αποθήκευση,2013,Ιανουάριος,0,58,5,1136,1199
I,9,Δραστηριότητες υπηρεσιών παροχής καταλύματος και υπηρεσιών εστίασης,2013,Ιανουάριος,0,4207,3681,3010,10898
J,10,Ενημέρωση και επικοινωνία,2013,Ιανουάριος,0,0,2,373,375
K,11,Χρηματοπιστωτικές και ασφαλιστικές δραστηριότητες,2013,Ιανουάριος,0,0,0,511,511
L,12,Διαχείριση ακίνητης περιουσίας,2013,Ιανουάριος,0,2,10,190,202
M,13,"Επαγγελματικές, επιστημονικές και τεχνικές δραστηριότητες",2013,Ιανουάριος,0,3,0,949,952
N,14,Διοικητικές και υποστηρικτικές δραστηριότητες,2013,Ιανουάριος,0,66,7,776,849
O,15,Δημόσια διοίκηση και άμυνα. Υποχρεωτική κοινωνική ασφάλιση,2013,Ιανουάριος,0,16,0,3124,3140
P,16,Εκπαίδευση,2013,Ιανουάριος,0,8,0,586,594
Q,17,Δραστηριότητες σχετικές με την ανθρώπινη υγεία και την κοινωνική μέριμνα,2013,Ιανουάριος,0,1,0,332,333
R,18,"Τέχνες, διασκέδαση και ψυχαγωγία",2013,Ιανουάριος,0,59,7,417,483
S,19,Άλλες δραστηριότητες παροχής υπηρεσιών,2013,Ιανουάριος,0,39,12,461,512
T,20,Δραστηριότητες νοικοκυριών ως εργοδοτών,2013,Ιανουάριος,0,0,1,50,51
U,21,Δραστηριότητες ετερόδικων οργανισμών και φορέων,2013,Ιανουάριος,0,0,0,20,20
N/A,22,Μη δηλωμένη οικονομική δραστηριότητα,2013,Ιανουάριος,0,0,0,2651,2651
LIM,23,Λιμενεργάτες,2013,Ιανουάριος,0,0,0,7,7
Σύνολο,Σύνολο,Σύνολο,2013,Ιανουάριος,141,4706,3755,27864,36466
A,1,"Γεωργία, δασοκομία και αλιεία",2013,Φεβρουάριος,0,0,0,159,159
B,2,Ορυχεία και λατομεία,2013,Φεβρουάριος,0,0,0,57,57
C,3,Μεταποίηση,2013,Φεβρουάριος,169,0,0,2703,2872
D,4,"Παροχή ηλεκτρικού ρεύματος, φυσικού αερίου, ατμού και κλιματισμού",2013,Φεβρουάριος,0,0,0,17,17
E,5,"Παροχή νερού, επεξεργασία λυμάτων, διαχείριση αποβλήτων και δραστηριότητες εξυγίανσης",2013,Φεβρουάριος,0,0,0,27,27
F,6,Κατασκευές,2013,Φεβρουάριος,0,5,8,4710,4723
G,7,Χονδρικό και λιανικό εμπόριο.  Επισκευή μηχανοκίνητων οχημάτων και μοτοσυκλετών,2013,Φεβρουάριος,0,251,21,5726,5998
H,8,Μεταφορά και αποθήκευση,2013,Φεβρουάριος,0,59,5,1115,1179
I,9,Δραστηριότητες υπηρεσιών παροχής καταλύματος και υπηρεσιών εστίασης,2013,Φεβρουάριος,0,4351,3590,3014,10955
J,10,Ενημέρωση και επικοινωνία,2013,Φεβρουάριος,0,0,2,369,371
K,11,Χρηματοπιστωτικές και ασφαλιστικές δραστηριότητες,2013,Φεβρουάριος,0,0,0,682,682
L,12,Διαχείριση ακίνητης περιουσίας,2013,Φεβρουάριος,0,2,12,187,201
M,13,"Επαγγελματικές, επιστημονικές και τεχνικές δραστηριότητες",2013,Φεβρουάριος,0,3,0,955,958
N,14,Διοικητικές και υποστηρικτικές δραστηριότητες,2013,Φεβρουάριος,0,69,7,751,827
O,15,Δημόσια διοίκηση και άμυνα. Υποχρεωτική κοινωνική ασφάλιση,2013,Φεβρουάριος,0,16,0,2759,2775
P,16,Εκπαίδευση,2013,Φεβρουάριος,0,9,0,413,422
Q,17,Δραστηριότητες σχετικές με την ανθρώπινη υγεία και την κοινωνική μέριμνα,2013,Φεβρουάριος,0,1,0,333,334
R,18,"Τέχνες, διασκέδαση και ψυχαγωγία",2013,Φεβρουάριος,0,60,7,414,481
S,19,Άλλες δραστηριότητες παροχής υπηρεσιών,2013,Φεβρουάριος,0,30,11,474,515
T,20,Δραστηριότητες νοικοκυριών ως εργοδοτών,2013,Φεβρουάριος,0,0,1,51,52
U,21,Δραστηριότητες ετερόδικων οργανισμών και φορέων,2013,Φεβρουάριος,0,0,0,17,17
N/A,22,Μη δηλωμένη οικονομική δραστηριότητα,2013,Φεβρουάριος,0,0,0,2580,2580
LIM,23,Λιμενεργάτες,2013,Φεβρουάριος,0,0,0,9,9
Σύνολο,Σύνολο,Σύνολο,2013,Φεβρουάριος,169,4856,3664,27522,36211
A,1,"Γεωργία, δασοκομία και αλιεία",2013,Μάρτιος,0,0,0,159,159
B,2,Ορυχεία και λατομεία,2013,Μάρτιος,0,0,0,58,58
C,3,Μεταποίηση,2013,Μάρτιος,103,0,0,2762,2865
D,4,"Παροχή ηλεκτρικού ρεύματος, φυσικού αερίου, ατμού και κλιματισμού",2013,Μάρτιος,0,0,0,17,17
E,5,"Παροχή νερού, επεξεργασία λυμάτων, διαχείριση αποβλήτων και δραστηριότητες εξυγίανσης",2013,Μάρτιος,0,0,0,23,23
F,6,Κατασκευές,2013,Μάρτιος,0,5,8,4668,4681
G,7,Χονδρικό και λιανικό εμπόριο.  Επισκευή μηχανοκίνητων οχημάτων και μοτοσυκλετών,2013,Μάρτιος,0,244,21,5979,6244
H,8,Μεταφορά και αποθήκευση,2013,Μάρτιος,0,58,5,1083,1146
I,9,Δραστηριότητες υπηρεσιών παροχής καταλύματος και υπηρεσιών εστίασης,2013,Μάρτιος,0,3629,3395,2944,9968
J,10,Ενημέρωση και επικοινωνία,2013,Μάρτιος,0,0,1,370,371
K,11,Χρηματοπιστωτικές και ασφαλιστικές δραστηριότητες,2013,Μάρτιος,0,0,0,691,691
L,12,Διαχείριση ακίνητης περιουσίας,2013,Μάρτιος,0,2,9,166,177
M,13,"Επαγγελματικές, επιστημονικές και τεχνικές δραστηριότητες",2013,Μάρτιος,0,3,0,977,980
N,14,Διοικητικές και υποστηρικτικές δραστηριότητες,2013,Μάρτιος,0,69,6,745,820
O,15,Δημόσια διοίκηση και άμυνα. Υποχρεωτική κοινωνική ασφάλιση,2013,Μάρτιος,0,16,0,2707,2723
P,16,Εκπαίδευση,2013,Μάρτιος,0,10,0,392,402
Q,17,Δραστηριότητες σχετικές με την ανθρώπινη υγεία και την κοινωνική μέριμνα,2013,Μάρτιος,0,1,0,333,334
R,18,"Τέχνες, διασκέδαση και ψυχαγωγία",2013,Μάρτιος,0,53,7,408,468
S,19,Άλλες δραστηριότητες παροχής υπηρεσιών,2013,Μάρτιος,0,31,11,470,512
T,20,Δραστηριότητες νοικοκυριών ως εργοδοτών,2013,Μάρτιος,0,0,1,51,52
U,21,Δραστηριότητες ετερόδικων οργανισμών και φορέων,2013,Μάρτιος,0,0,0,19,19
N/A,22,Μη δηλωμένη οικονομική δραστηριότητα,2013,Μάρτιος,0,0,0,2501,2501
LIM,23,Λιμενεργάτες,2013,Μάρτιος,0,0,0,23,23
Σύνολο,Σύνολο,Σύνολο,2013,Μάρτιος,103,4121,3464,27546,35234
A,1,"Γεωργία, δασοκομία και αλιεία",2013,Απρίλιος,0,0,0,165,165
B,2,Ορυχεία και λατομεία,2013,Απρίλιος,0,0,0,63,63
C,3,Μεταποίηση,2013,Απρίλιος,58,0,0,3096,3154
D,4,"Παροχή ηλεκτρικού ρεύματος, φυσικού αερίου, ατμού και κλιματισμού",2013,Απρίλιος,0,0,0,22,22
E,5,"Παροχή νερού, επεξεργασία λυμάτων, διαχείριση αποβλήτων και δραστηριότητες εξυγίανσης",2013,Απρίλιος,0,0,0,21,21
F,6,Κατασκευές,2013,Απρίλιος,0,0,8,5208,5216
G,7,Χονδρικό και λιανικό εμπόριο.  Επισκευή μηχανοκίνητων οχημάτων και μοτοσυκλετών,2013,Απρίλιος,0,0,19,6391,6410
H,8,Μεταφορά και αποθήκευση,2013,Απρίλιος,0,0,3,1006,1009
I,9,Δραστηριότητες υπηρεσιών παροχής καταλύματος και υπηρεσιών εστίασης,2013,Απρίλιος,0,0,2826,2754,5580
J,10,Ενημέρωση και επικοινωνία,2013,Απρίλιος,0,0,1,407,408
K,11,Χρηματοπιστωτικές και ασφαλιστικές δραστηριότητες,2013,Απρίλιος,0,0,0,704,704
L,12,Διαχείριση ακίνητης περιουσίας,2013,Απρίλιος,0,0,8,171,179
M,13,"Επαγγελματικές, επιστημονικές και τεχνικές δραστηριότητες",2013,Απρίλιος,0,0,0,1063,1063
N,14,Διοικητικές και υποστηρικτικές δραστηριότητες,2013,Απρίλιος,0,0,5,779,784
O,15,Δημόσια διοίκηση και άμυνα. Υποχρεωτική κοινωνική ασφάλιση,2013,Απρίλιος,0,0,0,2767,2767
P,16,Εκπαίδευση,2013,Απρίλιος,0,0,0,418,418
Q,17,Δραστηριότητες σχετικές με την ανθρώπινη υγεία και την κοινωνική μέριμνα,2013,Απρίλιος,0,0,0,340,340
R,18,"Τέχνες, διασκέδαση και ψυχαγωγία",2013,Απρίλιος,0,0,7,394,401
S,19,Άλλες δραστηριότητες παροχής υπηρεσιών,2013,Απρίλιος,0,0,11,476,487
T,20,Δραστηριότητες νοικοκυριών ως εργοδοτών,2013,Απρίλιος,0,0,0,50,50
U,21,Δραστηριότητες ετερόδικων οργανισμών και φορέων,2013,Απρίλιος,0,0,0,19,19
N/A,22,Μη δηλωμένη οικονομική δραστηριότητα,2013,Απρίλιος,0,0,0,2627,2627
LIM,23,Λιμενεργάτες,2013,Απρίλιος,0,0,0,0,0
Σύνολο,Σύνολο,Σύνολο,2013,Απρίλιος,58,0,2888,28941,31887
A,1,"Γεωργία, δασοκομία και αλιεία",2013,Μάιος,0,0,0,157,157
B,2,Ορυχεία και λατομεία,2013,Μάιος,0,0,0,74,74
C,3,Μεταποίηση,2013,Μάιος,27,0,0,3092,3119
D,4,"Παροχή ηλεκτρικού ρεύματος, φυσικού αερίου, ατμού και κλιματισμού",2013,Μάιος,0,0,0,18,18
E,5,"Παροχή νερού, επεξεργασία λυμάτων, διαχείριση αποβλήτων και δραστηριότητες εξυγίανσης",2013,Μάιος,0,0,0,22,22
F,6,Κατασκευές,2013,Μάιος,0,0,6,5028,5034
G,7,Χονδρικό και λιανικό εμπόριο.  Επισκευή μηχανοκίνητων οχημάτων και μοτοσυκλετών,2013,Μάιος,0,0,12,6133,6145
H,8,Μεταφορά και αποθήκευση,2013,Μάιος,0,0,3,747,750
I,9,Δραστηριότητες υπηρεσιών παροχής καταλύματος και υπηρεσιών εστίασης,2013,Μάιος,0,0,1070,1820,2890
J,10,Ενημέρωση και επικοινωνία,2013,Μάιος,0,0,0,431,431
K,11,Χρηματοπιστωτικές και ασφαλιστικές δραστηριότητες,2013,Μάιος,0,0,0,699,699
L,12,Διαχείριση ακίνητης περιουσίας,2013,Μάιος,0,0,3,174,177
M,13,"Επαγγελματικές, επιστημονικές και τεχνικές δραστηριότητες",2013,Μάιος,0,0,0,1139,1139
N,14,Διοικητικές και υποστηρικτικές δραστηριότητες,2013,Μάιος,0,0,1,593,594
O,15,Δημόσια διοίκηση και άμυνα. Υποχρεωτική κοινωνική ασφάλιση,2013,Μάιος,0,0,0,2652,2652
P,16,Εκπαίδευση,2013,Μάιος,0,0,0,506,506
Q,17,Δραστηριότητες σχετικές με την ανθρώπινη υγεία και την κοινωνική μέριμνα,2013,Μάιος,0,0,0,324,324
R,18,"Τέχνες, διασκέδαση και ψυχαγωγία",2013,Μάιος,0,0,4,313,317
S,19,Άλλες δραστηριότητες παροχής υπηρεσιών,2013,Μάιος,0,0,5,398,403
T,20,Δραστηριότητες νοικοκυριών ως εργοδοτών,2013,Μάιος,0,0,0,45,45
U,21,Δραστηριότητες ετερόδικων οργανισμών και φορέων,2013,Μάιος,0,0,0,18,18
N/A,22,Μη δηλωμένη οικονομική δραστηριότητα,2013,Μάιος,0,0,0,2449,2449
LIM,23,Λιμενεργάτες,2013,Μάιος,0,0,0,18,18
Σύνολο,Σύνολο,Σύνολο,2013,Μάιος,27,0,1104,26850,27981
A,1,"Γεωργία, δασοκομία και αλιεία",2013,Ιούνιος,0,0,0,156,156
B,2,Ορυχεία και λατομεία,2013,Ιούνιος,0,0,0,80,80
C,3,Μεταποίηση,2013,Ιούνιος,12,0,0,3071,3083
D,4,"Παροχή ηλεκτρικού ρεύματος, φυσικού αερίου, ατμού και κλιματισμού",2013,Ιούνιος,0,0,0,22,22
E,5,"Παροχή νερού, επεξεργασία λυμάτων, διαχείριση αποβλήτων και δραστηριότητες εξυγίανσης",2013,Ιούνιος,0,0,0,18,18
F,6,Κατασκευές,2013,Ιούνιος,0,0,0,4978,4978
G,7,Χονδρικό και λιανικό εμπόριο.  Επισκευή μηχανοκίνητων οχημάτων και μοτοσυκλετών,2013,Ιούνιος,0,0,0,5965,5965
H,8,Μεταφορά και αποθήκευση,2013,Ιούνιος,0,0,0,645,645
I,9,Δραστηριότητες υπηρεσιών παροχής καταλύματος και υπηρεσιών εστίασης,2013,Ιούνιος,0,0,519,1473,1992
J,10,Ενημέρωση και επικοινωνία,2013,Ιούνιος,0,0,0,486,486
K,11,Χρηματοπιστωτικές και ασφαλιστικές δραστηριότητες,2013,Ιούνιος,0,0,0,668,668
L,12,Διαχείριση ακίνητης περιουσίας,2013,Ιούνιος,0,0,0,163,163
M,13,"Επαγγελματικές, επιστημονικές και τεχνικές δραστηριότητες",2013,Ιούνιος,0,0,0,1218,1218
N,14,Διοικητικές και υποστηρικτικές δραστηριότητες,2013,Ιούνιος,0,0,0,545,545
O,15,Δημόσια διοίκηση και άμυνα. Υποχρεωτική κοινωνική ασφάλιση,2013,Ιούνιος,0,0,0,2651,2651
P,16,Εκπαίδευση,2013,Ιούνιος,0,0,0,2214,2214
Q,17,Δραστηριότητες σχετικές με την ανθρώπινη υγεία και την κοινωνική μέριμνα,2013,Ιούνιος,0,0,0,327,327
R,18,"Τέχνες, διασκέδαση και ψυχαγωγία",2013,Ιούνιος,0,0,5,280,285
S,19,Άλλες δραστηριότητες παροχής υπηρεσιών,2013,Ιούνιος,0,0,4,467,471
T,20,Δραστηριότητες νοικοκυριών ως εργοδοτών,2013,Ιούνιος,0,0,0,48,48
U,21,Δραστηριότητες ετερόδικων οργανισμών και φορέων,2013,Ιούνιος,0,0,0,18,18
N/A,22,Μη δηλωμένη οικονομική δραστηριότητα,2013,Ιούνιος,0,0,0,2235,2235
LIM,23,Λιμενεργάτες,2013,Ιούνιος,0,0,0,22,22
Σύνολο,Σύνολο,Σύνολο,2013,Ιούνιος,12,0,528,27750,28290
A,1,"Γεωργία, δασοκομία και αλιεία",2013,Ιούλιος,0,0,0,162,162
B,2,Ορυχεία και λατομεία,2013,Ιούλιος,0,0,0,78,78
C,3,Μεταποίηση,2013,Ιούλιος,7,0,0,3063,3070
D,4,"Παροχή ηλεκτρικού ρεύματος, φυσικού αερίου, ατμού και κλιματισμού",2013,Ιούλιος,0,0,0,20,20
E,5,"Παροχή νερού, επεξεργασία λυμάτων, διαχείριση αποβλήτων και δραστηριότητες εξυγίανσης",2013,Ιούλιος,0,0,0,15,15
F,6,Κατασκευές,2013,Ιούλιος,0,0,0,5064,5064
G,7,Χονδρικό και λιανικό εμπόριο.  Επισκευή μηχανοκίνητων οχημάτων και μοτοσυκλετών,2013,Ιούλιος,0,0,0,5991,5991
H,8,Μεταφορά και αποθήκευση,2013,Ιούλιος,0,0,0,663,663
I,9,Δραστηριότητες υπηρεσιών παροχής καταλύματος και υπηρεσιών εστίασης,2013,Ιούλιος,0,0,409,1462,1871
J,10,Ενημέρωση και επικοινωνία,2013,Ιούλιος,0,0,0,523,523
K,11,Χρηματοπιστωτικές και ασφαλιστικές δραστηριότητες,2013,Ιούλιος,0,0,0,714,714
L,12,Διαχείριση ακίνητης περιουσίας,2013,Ιούλιος,0,0,0,166,166
M,13,"Επαγγελματικές, επιστημονικές και τεχνικές δραστηριότητες",2013,Ιούλιος,0,0,0,1291,1291
N,14,Διοικητικές και υποστηρικτικές δραστηριότητες,2013,Ιούλιος,0,0,0,514,514
O,15,Δημόσια διοίκηση και άμυνα. Υποχρεωτική κοινωνική ασφάλιση,2013,Ιούλιος,0,0,0,2401,2401
P,16,Εκπαίδευση,2013,Ιούλιος,0,0,0,3314,3314
Q,17,Δραστηριότητες σχετικές με την ανθρώπινη υγεία και την κοινωνική μέριμνα,2013,Ιούλιος,0,0,0,372,372
R,18,"Τέχνες, διασκέδαση και ψυχαγωγία",2013,Ιούλιος,0,0,5,290,295
S,19,Άλλες δραστηριότητες παροχής υπηρεσιών,2013,Ιούλιος,0,0,4,567,571
T,20,Δραστηριότητες νοικοκυριών ως εργοδοτών,2013,Ιούλιος,0,0,0,45,45
U,21,Δραστηριότητες ετερόδικων οργανισμών και φορέων,2013,Ιούλιος,0,0,0,21,21
N/A,22,Μη δηλωμένη οικονομική δραστηριότητα,2013,Ιούλιος,0,0,0,2363,2363
LIM,23,Λιμενεργάτες,2013,Ιούλιος,0,0,0,4,4
Σύνολο,Σύνολο,Σύνολο,2013,Ιούλιος,7,0,418,29103,29528
A,1,"Γεωργία, δασοκομία και αλιεία",2013,Αύγουστος,0,0,0,164,164
B,2,Ορυχεία και λατομεία,2013,Αύγουστος,0,0,0,83,83
C,3,Μεταποίηση,2013,Αύγουστος,0,0,0,2947,2947
D,4,"Παροχή ηλεκτρικού ρεύματος, φυσικού αερίου, ατμού και κλιματισμού",2013,Αύγουστος,0,0,0,20,20
E,5,"Παροχή νερού, επεξεργασία λυμάτων, διαχείριση αποβλήτων και δραστηριότητες εξυγίανσης",2013,Αύγουστος,0,0,0,15,15
F,6,Κατασκευές,2013,Αύγουστος,0,0,0,4807,4807
G,7,Χονδρικό και λιανικό εμπόριο.  Επισκευή μηχανοκίνητων οχημάτων και μοτοσυκλετών,2013,Αύγουστος,0,0,0,5875,5875
H,8,Μεταφορά και αποθήκευση,2013,Αύγουστος,0,0,0,806,806
I,9,Δραστηριότητες υπηρεσιών παροχής καταλύματος και υπηρεσιών εστίασης,2013,Αύγουστος,0,0,323,1414,1737
J,10,Ενημέρωση και επικοινωνία,2013,Αύγουστος,0,0,0,506,506
K,11,Χρηματοπιστωτικές και ασφαλιστικές δραστηριότητες,2013,Αύγουστος,0,0,0,1975,1975
L,12,Διαχείριση ακίνητης περιουσίας,2013,Αύγουστος,0,0,3,169,172
M,13,"Επαγγελματικές, επιστημονικές και τεχνικές δραστηριότητες",2013,Αύγουστος,0,0,0,1281,1281
N,14,Διοικητικές και υποστηρικτικές δραστηριότητες,2013,Αύγουστος,0,0,0,478,478
O,15,Δημόσια διοίκηση και άμυνα. Υποχρεωτική κοινωνική ασφάλιση,2013,Αύγουστος,0,0,0,2188,2188
P,16,Εκπαίδευση,2013,Αύγουστος,0,0,0,3444,3444
Q,17,Δραστηριότητες σχετικές με την ανθρώπινη υγεία και την κοινωνική μέριμνα,2013,Αύγουστος,0,0,0,382,382
R,18,"Τέχνες, διασκέδαση και ψυχαγωγία",2013,Αύγουστος,0,0,2,294,296
S,19,Άλλες δραστηριότητες παροχής υπηρεσιών,2013,Αύγουστος,0,0,1,622,623
T,20,Δραστηριότητες νοικοκυριών ως εργοδοτών,2013,Αύγουστος,0,0,0,52,52
U,21,Δραστηριότητες ετερόδικων οργανισμών και φορέων,2013,Αύγουστος,0,0,0,20,20
N/A,22,Μη δηλωμένη οικονομική δραστηριότητα,2013,Αύγουστος,0,0,0,2451,2451
LIM,23,Λιμενεργάτες,2013,Αύγουστος,0,0,0,23,23
Σύνολο,Σύνολο,Σύνολο,2013,Αύγουστος,0,0,329,30016,30345
A,1,"Γεωργία, δασοκομία και αλιεία",2013,Σεπτέμβριος,0,0,0,170,170
B,2,Ορυχεία και λατομεία,2013,Σεπτέμβριος,0,0,0,74,74
C,3,Μεταποίηση,2013,Σεπτέμβριος,12,0,0,2865,2877
D,4,"Παροχή ηλεκτρικού ρεύματος, φυσικού αερίου, ατμού και κλιματισμού",2013,Σεπτέμβριος,0,0,0,19,19
E,5,"Παροχή νερού, επεξεργασία λυμάτων, διαχείριση αποβλήτων και δραστηριότητες εξυγίανσης",2013,Σεπτέμβριος,0,0,0,11,11
F,6,Κατασκευές,2013,Σεπτέμβριος,0,0,8,4552,4560
G,7,Χονδρικό και λιανικό εμπόριο.  Επισκευή μηχανοκίνητων οχημάτων και μοτοσυκλετών,2013,Σεπτέμβριος,0,0,8,5581,5589
H,8,Μεταφορά και αποθήκευση,2013,Σεπτέμβριος,0,0,1,786,787
I,9,Δραστηριότητες υπηρεσιών παροχής καταλύματος και υπηρεσιών εστίασης,2013,Σεπτέμβριος,0,0,281,1435,1716
J,10,Ενημέρωση και επικοινωνία,2013,Σεπτέμβριος,0,0,0,482,482
K,11,Χρηματοπιστωτικές και ασφαλιστικές δραστηριότητες,2013,Σεπτέμβριος,0,0,0,2063,2063
L,12,Διαχείριση ακίνητης περιουσίας,2013,Σεπτέμβριος,0,0,2,166,168
M,13,"Επαγγελματικές, επιστημονικές και τεχνικές δραστηριότητες",2013,Σεπτέμβριος,0,0,0,1268,1268
N,14,Διοικητικές και υποστηρικτικές δραστηριότητες,2013,Σεπτέμβριος,0,0,0,472,472
O,15,Δημόσια διοίκηση και άμυνα. Υποχρεωτική κοινωνική ασφάλιση,2013,Σεπτέμβριος,0,0,0,2275,2275
P,16,Εκπαίδευση,2013,Σεπτέμβριος,0,0,0,3244,3244
Q,17,Δραστηριότητες σχετικές με την ανθρώπινη υγεία και την κοινωνική μέριμνα,2013,Σεπτέμβριος,0,0,0,383,383
R,18,"Τέχνες, διασκέδαση και ψυχαγωγία",2013,Σεπτέμβριος,0,0,2,282,284
S,19,Άλλες δραστηριότητες παροχής υπηρεσιών,2013,Σεπτέμβριος,0,0,1,598,599
T,20,Δραστηριότητες νοικοκυριών ως εργοδοτών,2013,Σεπτέμβριος,0,0,0,45,45
U,21,Δραστηριότητες ετερόδικων οργανισμών και φορέων,2013,Σεπτέμβριος,0,0,0,21,21
N/A,22,Μη δηλωμένη οικονομική δραστηριότητα,2013,Σεπτέμβριος,0,0,0,2439,2439
LIM,23,Λιμενεργάτες,2013,Σεπτέμβριος,0,0,0,4,4
Σύνολο,Σύνολο,Σύνολο,2013,Σεπτέμβριος,12,0,303,29235,29550
A,1,"Γεωργία, δασοκομία και αλιεία",2013,Οκτώβριος,0,0,0,168,168
B,2,Ορυχεία και λατομεία,2013,Οκτώβριος,0,0,0,72,72
C,3,Μεταποίηση,2013,Οκτώβριος,18,0,0,2934,2952
D,4,"Παροχή ηλεκτρικού ρεύματος, φυσικού αερίου, ατμού και κλιματισμού",2013,Οκτώβριος,0,0,0,26,26
E,5,"Παροχή νερού, επεξεργασία λυμάτων, διαχείριση αποβλήτων και δραστηριότητες εξυγίανσης",2013,Οκτώβριος,0,0,0,11,11
F,6,Κατασκευές,2013,Οκτώβριος,0,0,10,4520,4530
G,7,Χονδρικό και λιανικό εμπόριο.  Επισκευή μηχανοκίνητων οχημάτων και μοτοσυκλετών,2013,Οκτώβριος,0,1,7,5515,5523
H,8,Μεταφορά και αποθήκευση,2013,Οκτώβριος,0,0,0,795,795
I,9,Δραστηριότητες υπηρεσιών παροχής καταλύματος και υπηρεσιών εστίασης,2013,Οκτώβριος,0,1,476,1442,1919
J,10,Ενημέρωση και επικοινωνία,2013,Οκτώβριος,0,0,0,457,457
K,11,Χρηματοπιστωτικές και ασφαλιστικές δραστηριότητες,2013,Οκτώβριος,0,0,0,2127,2127
L,12,Διαχείριση ακίνητης περιουσίας,2013,Οκτώβριος,0,0,0,158,158
M,13,"Επαγγελματικές, επιστημονικές και τεχνικές δραστηριότητες",2013,Οκτώβριος,0,0,0,1263,1263
N,14,Διοικητικές και υποστηρικτικές δραστηριότητες,2013,Οκτώβριος,0,0,0,487,487
O,15,Δημόσια διοίκηση και άμυνα. Υποχρεωτική κοινωνική ασφάλιση,2013,Οκτώβριος,0,0,0,1268,1268
P,16,Εκπαίδευση,2013,Οκτώβριος,0,0,0,1606,1606
Q,17,Δραστηριότητες σχετικές με την ανθρώπινη υγεία και την κοινωνική μέριμνα,2013,Οκτώβριος,0,0,0,383,383
R,18,"Τέχνες, διασκέδαση και ψυχαγωγία",2013,Οκτώβριος,0,0,2,259,261
S,19,Άλλες δραστηριότητες παροχής υπηρεσιών,2013,Οκτώβριος,0,0,4,429,433
T,20,Δραστηριότητες νοικοκυριών ως εργοδοτών,2013,Οκτώβριος,0,0,0,41,41
U,21,Δραστηριότητες ετερόδικων οργανισμών και φορέων,2013,Οκτώβριος,0,0,0,20,20
N/A,22,Μη δηλωμένη οικονομική δραστηριότητα,2013,Οκτώβριος,0,1,5,2587,2593
LIM,23,Λιμενεργάτες,2013,Οκτώβριος,0,0,0,0,0
Σύνολο,Σύνολο,Σύνολο,2013,Οκτώβριος,18,3,504,26568,27093
A,1,"Γεωργία, δασοκομία και αλιεία",2013,Νοέμβριος,0,0,0,154,154
B,2,Ορυχεία και λατομεία,2013,Νοέμβριος,0,0,0,66,66
C,3,Μεταποίηση,2013,Νοέμβριος,33,0,0,2850,2883
D,4,"Παροχή ηλεκτρικού ρεύματος, φυσικού αερίου, ατμού και κλιματισμού",2013,Νοέμβριος,0,0,0,42,42
E,5,"Παροχή νερού, επεξεργασία λυμάτων, διαχείριση αποβλήτων και δραστηριότητες εξυγίανσης",2013,Νοέμβριος,0,0,0,10,10
F,6,Κατασκευές,2013,Νοέμβριος,0,3,15,4328,4346
G,7,Χονδρικό και λιανικό εμπόριο.  Επισκευή μηχανοκίνητων οχημάτων και μοτοσυκλετών,2013,Νοέμβριος,0,182,22,5435,5639
H,8,Μεταφορά και αποθήκευση,2013,Νοέμβριος,0,41,2,1166,1209
I,9,Δραστηριότητες υπηρεσιών παροχής καταλύματος και υπηρεσιών εστίασης,2013,Νοέμβριος,0,2146,3393,2443,7982
J,10,Ενημέρωση και επικοινωνία,2013,Νοέμβριος,0,0,1,446,447
K,11,Χρηματοπιστωτικές και ασφαλιστικές δραστηριότητες,2013,Νοέμβριος,0,1,0,2049,2050
L,12,Διαχείριση ακίνητης περιουσίας,2013,Νοέμβριος,0,13,7,178,198
M,13,"Επαγγελματικές, επιστημονικές και τεχνικές δραστηριότητες",2013,Νοέμβριος,0,2,0,1202,1204
N,14,Διοικητικές και υποστηρικτικές δραστηριότητες,2013,Νοέμβριος,0,66,9,663,738
O,15,Δημόσια διοίκηση και άμυνα. Υποχρεωτική κοινωνική ασφάλιση,2013,Νοέμβριος,0,13,0,1103,1116
P,16,Εκπαίδευση,2013,Νοέμβριος,0,10,0,668,678
Q,17,Δραστηριότητες σχετικές με την ανθρώπινη υγεία και την κοινωνική μέριμνα,2013,Νοέμβριος,0,0,1,391,392
R,18,"Τέχνες, διασκέδαση και ψυχαγωγία",2013,Νοέμβριος,0,49,5,355,409
S,19,Άλλες δραστηριότητες παροχής υπηρεσιών,2013,Νοέμβριος,0,5,12,487,504
T,20,Δραστηριότητες νοικοκυριών ως εργοδοτών,2013,Νοέμβριος,0,0,0,41,41
U,21,Δραστηριότητες ετερόδικων οργανισμών και φορέων,2013,Νοέμβριος,0,0,0,17,17
N/A,22,Μη δηλωμένη οικονομική δραστηριότητα,2013,Νοέμβριος,0,0,12,2489,2501
LIM,23,Λιμενεργάτες,2013,Νοέμβριος,0,0,0,17,17
Σύνολο,Σύνολο,Σύνολο,2013,Νοέμβριος,33,2531,3479,26600,32643
A,1,"Γεωργία, δασοκομία και αλιεία",2013,Δεκέμβριος,0,0,0,133,133
B,2,Ορυχεία και λατομεία,2013,Δεκέμβριος,0,0,0,62,62
C,3,Μεταποίηση,2013,Δεκέμβριος,38,0,0,2825,2863
D,4,"Παροχή ηλεκτρικού ρεύματος, φυσικού αερίου, ατμού και κλιματισμού",2013,Δεκέμβριος,0,0,0,44,44
E,5,"Παροχή νερού, επεξεργασία λυμάτων, διαχείριση αποβλήτων και δραστηριότητες εξυγίανσης",2013,Δεκέμβριος,0,0,0,12,12
F,6,Κατασκευές,2013,Δεκέμβριος,0,3,17,4123,4143
G,7,Χονδρικό και λιανικό εμπόριο.  Επισκευή μηχανοκίνητων οχημάτων και μοτοσυκλετών,2013,Δεκέμβριος,0,230,31,5295,5556
H,8,Μεταφορά και αποθήκευση,2013,Δεκέμβριος,0,49,3,1317,1369
I,9,Δραστηριότητες υπηρεσιών παροχής καταλύματος και υπηρεσιών εστίασης,2013,Δεκέμβριος,0,4037,4300,2835,11172
J,10,Ενημέρωση και επικοινωνία,2013,Δεκέμβριος,0,1,1,431,433
K,11,Χρηματοπιστωτικές και ασφαλιστικές δραστηριότητες,2013,Δεκέμβριος,0,1,0,2017,2018
L,12,Διαχείριση ακίνητης περιουσίας,2013,Δεκέμβριος,0,15,8,174,197
M,13,"Επαγγελματικές, επιστημονικές και τεχνικές δραστηριότητες",2013,Δεκέμβριος,0,3,0,1170,1173
N,14,Διοικητικές και υποστηρικτικές δραστηριότητες,2013,Δεκέμβριος,0,68,11,706,785
O,15,Δημόσια διοίκηση και άμυνα. Υποχρεωτική κοινωνική ασφάλιση,2013,Δεκέμβριος,0,14,0,2280,2294
P,16,Εκπαίδευση,2013,Δεκέμβριος,0,11,1,535,547
Q,17,Δραστηριότητες σχετικές με την ανθρώπινη υγεία και την κοινωνική μέριμνα,2013,Δεκέμβριος,0,0,1,389,390
R,18,"Τέχνες, διασκέδαση και ψυχαγωγία",2013,Δεκέμβριος,0,59,8,348,415
S,19,Άλλες δραστηριότητες παροχής υπηρεσιών,2013,Δεκέμβριος,0,15,12,514,541
T,20,Δραστηριότητες νοικοκυριών ως εργοδοτών,2013,Δεκέμβριος,0,0,0,38,38
U,21,Δραστηριότητες ετερόδικων οργανισμών και φορέων,2013,Δεκέμβριος,0,0,0,16,16
N/A,22,Μη δηλωμένη οικονομική δραστηριότητα,2013,Δεκέμβριος,0,1,16,2480,2497
LIM,23,Λιμενεργάτες,2013,Δεκέμβριος,0,0,0,18,18
Σύνολο,Σύνολο,Σύνολο,2013,Δεκέμβριος,38,4507,4409,27762,36716
A,1,"Γεωργία, δασοκομία και αλιεία",2014,Ιανουάριος,0,1,0,136,137
B,2,Ορυχεία και λατομεία,2014,Ιανουάριος,0,0,0,60,60
C,3,Μεταποίηση,2014,Ιανουάριος,61,0,1,2795,2857
D,4,"Παροχή ηλεκτρικού ρεύματος, φυσικού αερίου, ατμού και κλιματισμού",2014,Ιανουάριος,0,0,0,51,51
E,5,"Παροχή νερού, επεξεργασία λυμάτων, διαχείριση αποβλήτων και δραστηριότητες εξυγίανσης",2014,Ιανουάριος,0,0,0,17,17
F,6,Κατασκευές,2014,Ιανουάριος,0,4,19,4035,4058
G,7,Χονδρικό και λιανικό εμπόριο.  Επισκευή μηχανοκίνητων οχημάτων και μοτοσυκλετών,2014,Ιανουάριος,0,251,30,5226,5507
H,8,Μεταφορά και αποθήκευση,2014,Ιανουάριος,0,50,3,1360,1413
I,9,Δραστηριότητες υπηρεσιών παροχής καταλύματος και υπηρεσιών εστίασης,2014,Ιανουάριος,0,4801,4321,3108,12230
J,10,Ενημέρωση και επικοινωνία,2014,Ιανουάριος,0,1,1,419,421
K,11,Χρηματοπιστωτικές και ασφαλιστικές δραστηριότητες,2014,Ιανουάριος,0,1,0,1983,1984
L,12,Διαχείριση ακίνητης περιουσίας,2014,Ιανουάριος,0,14,10,194,218
M,13,"Επαγγελματικές, επιστημονικές και τεχνικές δραστηριότητες",2014,Ιανουάριος,0,3,0,1133,1136
N,14,Διοικητικές και υποστηρικτικές δραστηριότητες,2014,Ιανουάριος,0,67,9,734,810
O,15,Δημόσια διοίκηση και άμυνα. Υποχρεωτική κοινωνική ασφάλιση,2014,Ιανουάριος,0,14,0,2824,2838
P,16,Εκπαίδευση,2014,Ιανουάριος,0,10,1,519,530
Q,17,Δραστηριότητες σχετικές με την ανθρώπινη υγεία και την κοινωνική μέριμνα,2014,Ιανουάριος,0,0,1,389,390
R,18,"Τέχνες, διασκέδαση και ψυχαγωγία",2014,Ιανουάριος,0,68,7,360,435
S,19,Άλλες δραστηριότητες παροχής υπηρεσιών,2014,Ιανουάριος,0,29,14,541,584
T,20,Δραστηριότητες νοικοκυριών ως εργοδοτών,2014,Ιανουάριος,0,0,0,45,45
U,21,Δραστηριότητες ετερόδικων οργανισμών και φορέων,2014,Ιανουάριος,0,0,0,17,17
N/A,22,Μη δηλωμένη οικονομική δραστηριότητα,2014,Ιανουάριος,0,14,24,2550,2588
LIM,23,Λιμενεργάτες,2014,Ιανουάριος,0,0,0,7,7
Σύνολο,Σύνολο,Σύνολο,2014,Ιανουάριος,61,5328,4441,28503,38333
A,1,"Γεωργία, δασοκομία και αλιεία",2014,Φεβρουάριος,0,1,0,127,128
B,2,Ορυχεία και λατομεία,2014,Φεβρουάριος,0,0,0,51,51
C,3,Μεταποίηση,2014,Φεβρουάριος,69,0,1,2681,2751
D,4,"Παροχή ηλεκτρικού ρεύματος, φυσικού αερίου, ατμού και κλιματισμού",2014,Φεβρουάριος,0,0,0,48,48
E,5,"Παροχή νερού, επεξεργασία λυμάτων, διαχείριση αποβλήτων και δραστηριότητες εξυγίανσης",2014,Φεβρουάριος,0,0,0,15,15
F,6,Κατασκευές,2014,Φεβρουάριος,0,4,19,3761,3784
G,7,Χονδρικό και λιανικό εμπόριο.  Επισκευή μηχανοκίνητων οχημάτων και μοτοσυκλετών,2014,Φεβρουάριος,0,250,28,4990,5268
H,8,Μεταφορά και αποθήκευση,2014,Φεβρουάριος,0,45,4,1333,1382
I,9,Δραστηριότητες υπηρεσιών παροχής καταλύματος και υπηρεσιών εστίασης,2014,Φεβρουάριος,0,4666,4178,3086,11930
J,10,Ενημέρωση και επικοινωνία,2014,Φεβρουάριος,0,1,1,393,395
K,11,Χρηματοπιστωτικές και ασφαλιστικές δραστηριότητες,2014,Φεβρουάριος,0,1,0,1895,1896
L,12,Διαχείριση ακίνητης περιουσίας,2014,Φεβρουάριος,0,14,11,206,231
M,13,"Επαγγελματικές, επιστημονικές και τεχνικές δραστηριότητες",2014,Φεβρουάριος,0,2,0,1059,1061
N,14,Διοικητικές και υποστηρικτικές δραστηριότητες,2014,Φεβρουάριος,0,68,9,679,756
O,15,Δημόσια διοίκηση και άμυνα. Υποχρεωτική κοινωνική ασφάλιση,2014,Φεβρουάριος,0,14,0,2734,2748
P,16,Εκπαίδευση,2014,Φεβρουάριος,0,11,1,461,473
Q,17,Δραστηριότητες σχετικές με την ανθρώπινη υγεία και την κοινωνική μέριμνα,2014,Φεβρουάριος,0,0,1,367,368
R,18,"Τέχνες, διασκέδαση και ψυχαγωγία",2014,Φεβρουάριος,0,63,7,346,416
S,19,Άλλες δραστηριότητες παροχής υπηρεσιών,2014,Φεβρουάριος,0,40,13,515,568
T,20,Δραστηριότητες νοικοκυριών ως εργοδοτών,2014,Φεβρουάριος,0,0,0,35,35
U,21,Δραστηριότητες ετερόδικων οργανισμών και φορέων,2014,Φεβρουάριος,0,0,0,15,15
N/A,22,Μη δηλωμένη οικονομική δραστηριότητα,2014,Φεβρουάριος,0,20,25,2520,2565
LIM,23,Λιμενεργάτες,2014,Φεβρουάριος,0,0,0,17,17
Σύνολο,Σύνολο,Σύνολο,2014,Φεβρουάριος,69,5200,4298,27334,36901
A,1,"Γεωργία, δασοκομία και αλιεία",2014,Μάρτιος,0,1,0,130,131
B,2,Ορυχεία και λατομεία,2014,Μάρτιος,0,0,0,49,49
C,3,Μεταποίηση,2014,Μάρτιος,43,0,1,2577,2621
D,4,"Παροχή ηλεκτρικού ρεύματος, φυσικού αερίου, ατμού και κλιματισμού",2014,Μάρτιος,0,0,0,50,50
E,5,"Παροχή νερού, επεξεργασία λυμάτων, διαχείριση αποβλήτων και δραστηριότητες εξυγίανσης",2014,Μάρτιος,0,0,0,10,10
F,6,Κατασκευές,2014,Μάρτιος,0,5,19,3600,3624
G,7,Χονδρικό και λιανικό εμπόριο.  Επισκευή μηχανοκίνητων οχημάτων και μοτοσυκλετών,2014,Μάρτιος,0,235,25,4830,5090
H,8,Μεταφορά και αποθήκευση,2014,Μάρτιος,0,44,4,1257,1305
I,9,Δραστηριότητες υπηρεσιών παροχής καταλύματος και υπηρεσιών εστίασης,2014,Μάρτιος,0,3936,3990,2996,10922
J,10,Ενημέρωση και επικοινωνία,2014,Μάρτιος,0,1,2,383,386
K,11,Χρηματοπιστωτικές και ασφαλιστικές δραστηριότητες,2014,Μάρτιος,0,1,0,1827,1828
L,12,Διαχείριση ακίνητης περιουσίας,2014,Μάρτιος,0,5,10,167,182
M,13,"Επαγγελματικές, επιστημονικές και τεχνικές δραστηριότητες",2014,Μάρτιος,0,2,0,994,996
N,14,Διοικητικές και υποστηρικτικές δραστηριότητες,2014,Μάρτιος,0,64,8,640,712
O,15,Δημόσια διοίκηση και άμυνα. Υποχρεωτική κοινωνική ασφάλιση,2014,Μάρτιος,0,14,0,2733,2747
P,16,Εκπαίδευση,2014,Μάρτιος,0,10,0,425,435
Q,17,Δραστηριότητες σχετικές με την ανθρώπινη υγεία και την κοινωνική μέριμνα,2014,Μάρτιος,0,0,1,347,348
R,18,"Τέχνες, διασκέδαση και ψυχαγωγία",2014,Μάρτιος,0,61,6,338,405
S,19,Άλλες δραστηριότητες παροχής υπηρεσιών,2014,Μάρτιος,0,29,12,498,539
T,20,Δραστηριότητες νοικοκυριών ως εργοδοτών,2014,Μάρτιος,0,0,0,34,34
U,21,Δραστηριότητες ετερόδικων οργανισμών και φορέων,2014,Μάρτιος,0,0,0,16,16
N/A,22,Μη δηλωμένη οικονομική δραστηριότητα,2014,Μάρτιος,0,17,24,2532,2573
LIM,23,Λιμενεργάτες,2014,Μάρτιος,0,0,0,13,13
Σύνολο,Σύνολο,Σύνολο,2014,Μάρτιος,43,4425,4102,26446,35016
A,1,"Γεωργία, δασοκομία και αλιεία",2014,Απρίλιος,0,1,0,125,126
B,2,Ορυχεία και λατομεία,2014,Απρίλιος,0,0,0,51,51
C,3,Μεταποίηση,2014,Απρίλιος,15,0,0,2430,2445
D,4,"Παροχή ηλεκτρικού ρεύματος, φυσικού αερίου, ατμού και κλιματισμού",2014,Απρίλιος,0,0,0,51,51
E,5,"Παροχή νερού, επεξεργασία λυμάτων, διαχείριση αποβλήτων και δραστηριότητες εξυγίανσης",2014,Απρίλιος,0,0,0,11,11
F,6,Κατασκευές,2014,Απρίλιος,0,2,24,3430,3456
G,7,Χονδρικό και λιανικό εμπόριο.  Επισκευή μηχανοκίνητων οχημάτων και μοτοσυκλετών,2014,Απρίλιος,0,2,23,4628,4653
H,8,Μεταφορά και αποθήκευση,2014,Απρίλιος,0,3,3,1117,1123
I,9,Δραστηριότητες υπηρεσιών παροχής καταλύματος και υπηρεσιών εστίασης,2014,Απρίλιος,0,34,3095,2606,5735
J,10,Ενημέρωση και επικοινωνία,2014,Απρίλιος,0,0,2,369,371
K,11,Χρηματοπιστωτικές και ασφαλιστικές δραστηριότητες,2014,Απρίλιος,0,0,0,1710,1710
L,12,Διαχείριση ακίνητης περιουσίας,2014,Απρίλιος,0,1,8,128,137
M,13,"Επαγγελματικές, επιστημονικές και τεχνικές δραστηριότητες",2014,Απρίλιος,0,0,0,958,958
N,14,Διοικητικές και υποστηρικτικές δραστηριότητες,2014,Απρίλιος,0,0,6,579,585
O,15,Δημόσια διοίκηση και άμυνα. Υποχρεωτική κοινωνική ασφάλιση,2014,Απρίλιος,0,0,0,2773,2773
P,16,Εκπαίδευση,2014,Απρίλιος,0,0,0,416,416
Q,17,Δραστηριότητες σχετικές με την ανθρώπινη υγεία και την κοινωνική μέριμνα,2014,Απρίλιος,0,0,1,334,335
R,18,"Τέχνες, διασκέδαση και ψυχαγωγία",2014,Απρίλιος,0,1,5,316,322
S,19,Άλλες δραστηριότητες παροχής υπηρεσιών,2014,Απρίλιος,0,0,8,467,475
T,20,Δραστηριότητες νοικοκυριών ως εργοδοτών,2014,Απρίλιος,0,0,0,32,32
U,21,Δραστηριότητες ετερόδικων οργανισμών και φορέων,2014,Απρίλιος,0,0,0,14,14
N/A,22,Μη δηλωμένη οικονομική δραστηριότητα,2014,Απρίλιος,0,2,12,2415,2429
LIM,23,Λιμενεργάτες,2014,Απρίλιος,0,0,0,10,10
Σύνολο,Σύνολο,Σύνολο,2014,Απρίλιος,15,46,3187,24970,28218
A,1,"Γεωργία, δασοκομία και αλιεία",2014,Μάιος,0,1,0,113,114
B,2,Ορυχεία και λατομεία,2014,Μάιος,0,0,0,54,54
C,3,Μεταποίηση,2014,Μάιος,21,0,0,2213,2234
D,4,"Παροχή ηλεκτρικού ρεύματος, φυσικού αερίου, ατμού και κλιματισμού",2014,Μάιος,0,0,0,52,52
E,5,"Παροχή νερού, επεξεργασία λυμάτων, διαχείριση αποβλήτων και δραστηριότητες εξυγίανσης",2014,Μάιος,0,0,0,10,10
F,6,Κατασκευές,2014,Μάιος,0,2,16,3232,3250
G,7,Χονδρικό και λιανικό εμπόριο.  Επισκευή μηχανοκίνητων οχημάτων και μοτοσυκλετών,2014,Μάιος,0,12,11,4175,4198
H,8,Μεταφορά και αποθήκευση,2014,Μάιος,0,3,2,831,836
I,9,Δραστηριότητες υπηρεσιών παροχής καταλύματος και υπηρεσιών εστίασης,2014,Μάιος,0,3,1043,1655,2701
J,10,Ενημέρωση και επικοινωνία,2014,Μάιος,0,0,2,363,365
K,11,Χρηματοπιστωτικές και ασφαλιστικές δραστηριότητες,2014,Μάιος,0,0,0,1739,1739
L,12,Διαχείριση ακίνητης περιουσίας,2014,Μάιος,0,1,5,127,133
M,13,"Επαγγελματικές, επιστημονικές και τεχνικές δραστηριότητες",2014,Μάιος,0,0,0,919,919
N,14,Διοικητικές και υποστηρικτικές δραστηριότητες,2014,Μάιος,0,0,2,422,424
O,15,Δημόσια διοίκηση και άμυνα. Υποχρεωτική κοινωνική ασφάλιση,2014,Μάιος,0,0,0,2419,2419
P,16,Εκπαίδευση,2014,Μάιος,0,0,0,492,492
Q,17,Δραστηριότητες σχετικές με την ανθρώπινη υγεία και την κοινωνική μέριμνα,2014,Μάιος,0,0,0,296,296
R,18,"Τέχνες, διασκέδαση και ψυχαγωγία",2014,Μάιος,0,0,2,257,259
S,19,Άλλες δραστηριότητες παροχής υπηρεσιών,2014,Μάιος,0,0,5,394,399
T,20,Δραστηριότητες νοικοκυριών ως εργοδοτών,2014,Μάιος,0,0,0,34,34
U,21,Δραστηριότητες ετερόδικων οργανισμών και φορέων,2014,Μάιος,0,0,0,12,12
N/A,22,Μη δηλωμένη οικονομική δραστηριότητα,2014,Μάιος,0,3,7,2373,2383
LIM,23,Λιμενεργάτες,2014,Μάιος,0,0,0,12,12
Σύνολο,Σύνολο,Σύνολο,2014,Μάιος,21,25,1095,22194,23335
A,1,"Γεωργία, δασοκομία και αλιεία",2014,Ιούνιος,0,1,0,128,129
B,2,Ορυχεία και λατομεία,2014,Ιούνιος,0,0,0,44,44
C,3,Μεταποίηση,2014,Ιούνιος,1,0,0,1974,1975
D,4,"Παροχή ηλεκτρικού ρεύματος, φυσικού αερίου, ατμού και κλιματισμού",2014,Ιούνιος,0,0,0,53,53
E,5,"Παροχή νερού, επεξεργασία λυμάτων, διαχείριση αποβλήτων και δραστηριότητες εξυγίανσης",2014,Ιούνιος,0,0,0,11,11
F,6,Κατασκευές,2014,Ιούνιος,0,2,15,3057,3074
G,7,Χονδρικό και λιανικό εμπόριο.  Επισκευή μηχανοκίνητων οχημάτων και μοτοσυκλετών,2014,Ιούνιος,0,17,4,3826,3847
H,8,Μεταφορά και αποθήκευση,2014,Ιούνιος,0,0,1,769,770
I,9,Δραστηριότητες υπηρεσιών παροχής καταλύματος και υπηρεσιών εστίασης,2014,Ιούνιος,0,1,491,1412,1904
J,10,Ενημέρωση και επικοινωνία,2014,Ιούνιος,0,0,2,364,366
K,11,Χρηματοπιστωτικές και ασφαλιστικές δραστηριότητες,2014,Ιούνιος,0,0,0,1611,1611
L,12,Διαχείριση ακίνητης περιουσίας,2014,Ιούνιος,0,1,7,120,128
M,13,"Επαγγελματικές, επιστημονικές και τεχνικές δραστηριότητες",2014,Ιούνιος,0,0,0,869,869
N,14,Διοικητικές και υποστηρικτικές δραστηριότητες,2014,Ιούνιος,0,0,2,359,361
O,15,Δημόσια διοίκηση και άμυνα. Υποχρεωτική κοινωνική ασφάλιση,2014,Ιούνιος,0,0,0,2183,2183
P,16,Εκπαίδευση,2014,Ιούνιος,0,0,0,1363,1363
Q,17,Δραστηριότητες σχετικές με την ανθρώπινη υγεία και την κοινωνική μέριμνα,2014,Ιούνιος,0,0,0,292,292
R,18,"Τέχνες, διασκέδαση και ψυχαγωγία",2014,Ιούνιος,0,0,0,248,248
S,19,Άλλες δραστηριότητες παροχής υπηρεσιών,2014,Ιούνιος,0,0,2,461,463
T,20,Δραστηριότητες νοικοκυριών ως εργοδοτών,2014,Ιούνιος,0,0,0,35,35
U,21,Δραστηριότητες ετερόδικων οργανισμών και φορέων,2014,Ιούνιος,0,0,0,12,12
N/A,22,Μη δηλωμένη οικονομική δραστηριότητα,2014,Ιούνιος,0,0,5,3203,3208
LIM,23,Λιμενεργάτες,2014,Ιούνιος,0,0,0,12,12
Σύνολο,Σύνολο,Σύνολο,2014,Ιούνιος,1,22,529,22406,22958
A,1,"Γεωργία, δασοκομία και αλιεία",2014,Ιούλιος,0,1,0,132,133
B,2,Ορυχεία και λατομεία,2014,Ιούλιος,0,0,0,38,38
C,3,Μεταποίηση,2014,Ιούλιος,1,0,0,1827,1828
D,4,"Παροχή ηλεκτρικού ρεύματος, φυσικού αερίου, ατμού και κλιματισμού",2014,Ιούλιος,0,0,0,45,45
E,5,"Παροχή νερού, επεξεργασία λυμάτων, διαχείριση αποβλήτων και δραστηριότητες εξυγίανσης",2014,Ιούλιος,0,0,0,8,8
F,6,Κατασκευές,2014,Ιούλιος,0,2,13,2776,2791
G,7,Χονδρικό και λιανικό εμπόριο.  Επισκευή μηχανοκίνητων οχημάτων και μοτοσυκλετών,2014,Ιούλιος,0,16,4,3494,3514
H,8,Μεταφορά και αποθήκευση,2014,Ιούλιος,0,0,0,704,704
I,9,Δραστηριότητες υπηρεσιών παροχής καταλύματος και υπηρεσιών εστίασης,2014,Ιούλιος,0,1,349,1369,1719
J,10,Ενημέρωση και επικοινωνία,2014,Ιούλιος,0,0,2,459,461
K,11,Χρηματοπιστωτικές και ασφαλιστικές δραστηριότητες,2014,Ιούλιος,0,0,0,1519,1519
L,12,Διαχείριση ακίνητης περιουσίας,2014,Ιούλιος,0,0,7,109,116
M,13,"Επαγγελματικές, επιστημονικές και τεχνικές δραστηριότητες",2014,Ιούλιος,0,0,0,785,785
N,14,Διοικητικές και υποστηρικτικές δραστηριότητες,2014,Ιούλιος,0,0,2,347,349
O,15,Δημόσια διοίκηση και άμυνα. Υποχρεωτική κοινωνική ασφάλιση,2014,Ιούλιος,0,0,0,2015,2015
P,16,Εκπαίδευση,2014,Ιούλιος,0,0,0,2273,2273
Q,17,Δραστηριότητες σχετικές με την ανθρώπινη υγεία και την κοινωνική μέριμνα,2014,Ιούλιος,0,0,0,295,295
R,18,"Τέχνες, διασκέδαση και ψυχαγωγία",2014,Ιούλιος,0,0,0,257,257
S,19,Άλλες δραστηριότητες παροχής υπηρεσιών,2014,Ιούλιος,0,0,2,518,520
T,20,Δραστηριότητες νοικοκυριών ως εργοδοτών,2014,Ιούλιος,0,0,0,39,39
U,21,Δραστηριότητες ετερόδικων οργανισμών και φορέων,2014,Ιούλιος,0,0,0,14,14
N/A,22,Μη δηλωμένη οικονομική δραστηριότητα,2014,Ιούλιος,0,0,3,3155,3158
LIM,23,Λιμενεργάτες,2014,Ιούλιος,0,0,0,9,9
Σύνολο,Σύνολο,Σύνολο,2014,Ιούλιος,1,20,382,22187,22590
A,1,"Γεωργία, δασοκομία και αλιεία",2014,Αύγουστος,0,0,0,128,128
B,2,Ορυχεία και λατομεία,2014,Αύγουστος,0,0,0,32,32
C,3,Μεταποίηση,2014,Αύγουστος,0,0,0,1676,1676
D,4,"Παροχή ηλεκτρικού ρεύματος, φυσικού αερίου, ατμού και κλιματισμού",2014,Αύγουστος,0,0,0,39,39
E,5,"Παροχή νερού, επεξεργασία λυμάτων, διαχείριση αποβλήτων και δραστηριότητες εξυγίανσης",2014,Αύγουστος,0,0,0,12,12
F,6,Κατασκευές,2014,Αύγουστος,0,2,15,2481,2498
G,7,Χονδρικό και λιανικό εμπόριο.  Επισκευή μηχανοκίνητων οχημάτων και μοτοσυκλετών,2014,Αύγουστος,0,6,3,3211,3220
H,8,Μεταφορά και αποθήκευση,2014,Αύγουστος,0,0,0,677,677
I,9,Δραστηριότητες υπηρεσιών παροχής καταλύματος και υπηρεσιών εστίασης,2014,Αύγουστος,0,1,279,1311,1591
J,10,Ενημέρωση και επικοινωνία,2014,Αύγουστος,0,0,1,442,443
K,11,Χρηματοπιστωτικές και ασφαλιστικές δραστηριότητες,2014,Αύγουστος,0,0,0,1454,1454
L,12,Διαχείριση ακίνητης περιουσίας,2014,Αύγουστος,0,0,7,101,108
M,13,"Επαγγελματικές, επιστημονικές και τεχνικές δραστηριότητες",2014,Αύγουστος,0,0,0,728,728
N,14,Διοικητικές και υποστηρικτικές δραστηριότητες,2014,Αύγουστος,0,0,2,337,339
O,15,Δημόσια διοίκηση και άμυνα. Υποχρεωτική κοινωνική ασφάλιση,2014,Αύγουστος,0,0,0,2017,2017
P,16,Εκπαίδευση,2014,Αύγουστος,0,0,0,2316,2316
Q,17,Δραστηριότητες σχετικές με την ανθρώπινη υγεία και την κοινωνική μέριμνα,2014,Αύγουστος,0,0,0,302,302
R,18,"Τέχνες, διασκέδαση και ψυχαγωγία",2014,Αύγουστος,0,0,0,237,237
S,19,Άλλες δραστηριότητες παροχής υπηρεσιών,2014,Αύγουστος,0,0,2,491,493
T,20,Δραστηριότητες νοικοκυριών ως εργοδοτών,2014,Αύγουστος,0,0,0,35,35
U,21,Δραστηριότητες ετερόδικων οργανισμών και φορέων,2014,Αύγουστος,0,0,0,19,19
N/A,22,Μη δηλωμένη οικονομική δραστηριότητα,2014,Αύγουστος,0,0,4,3048,3052
LIM,23,Λιμενεργάτες,2014,Αύγουστος,0,0,0,16,16
Σύνολο,Σύνολο,Σύνολο,2014,Αύγουστος,0,9,313,21110,21432
A,1,"Γεωργία, δασοκομία και αλιεία",2014,Σεπτέμβριος,0,0,0,135,135
B,2,Ορυχεία και λατομεία,2014,Σεπτέμβριος,0,0,0,27,27
C,3,Μεταποίηση,2014,Σεπτέμβριος,0,0,1,1710,1711
D,4,"Παροχή ηλεκτρικού ρεύματος, φυσικού αερίου, ατμού και κλιματισμού",2014,Σεπτέμβριος,0,0,0,34,34
E,5,"Παροχή νερού, επεξεργασία λυμάτων, διαχείριση αποβλήτων και δραστηριότητες εξυγίανσης",2014,Σεπτέμβριος,0,0,0,13,13
F,6,Κατασκευές,2014,Σεπτέμβριος,0,2,14,2429,2445
G,7,Χονδρικό και λιανικό εμπόριο.  Επισκευή μηχανοκίνητων οχημάτων και μοτοσυκλετών,2014,Σεπτέμβριος,0,6,2,3252,3260
H,8,Μεταφορά και αποθήκευση,2014,Σεπτέμβριος,0,0,0,691,691
I,9,Δραστηριότητες υπηρεσιών παροχής καταλύματος και υπηρεσιών εστίασης,2014,Σεπτέμβριος,0,1,375,1421,1797
J,10,Ενημέρωση και επικοινωνία,2014,Σεπτέμβριος,0,0,1,437,438
K,11,Χρηματοπιστωτικές και ασφαλιστικές δραστηριότητες,2014,Σεπτέμβριος,0,0,0,1391,1391
L,12,Διαχείριση ακίνητης περιουσίας,2014,Σεπτέμβριος,0,0,7,89,96
M,13,"Επαγγελματικές, επιστημονικές και τεχνικές δραστηριότητες",2014,Σεπτέμβριος,0,0,0,734,734
N,14,Διοικητικές και υποστηρικτικές δραστηριότητες,2014,Σεπτέμβριος,0,0,2,367,369
O,15,Δημόσια διοίκηση και άμυνα. Υποχρεωτική κοινωνική ασφάλιση,2014,Σεπτέμβριος,0,0,0,1989,1989
P,16,Εκπαίδευση,2014,Σεπτέμβριος,0,0,0,2198,2198
Q,17,Δραστηριότητες σχετικές με την ανθρώπινη υγεία και την κοινωνική μέριμνα,2014,Σεπτέμβριος,0,0,0,315,315
R,18,"Τέχνες, διασκέδαση και ψυχαγωγία",2014,Σεπτέμβριος,0,0,0,236,236
S,19,Άλλες δραστηριότητες παροχής υπηρεσιών,2014,Σεπτέμβριος,0,0,3,492,495
T,20,Δραστηριότητες νοικοκυριών ως εργοδοτών,2014,Σεπτέμβριος,0,0,0,38,38
U,21,Δραστηριότητες ετερόδικων οργανισμών και φορέων,2014,Σεπτέμβριος,0,0,0,17,17
N/A,22,Μη δηλωμένη οικονομική δραστηριότητα,2014,Σεπτέμβριος,0,0,5,3061,3066
LIM,23,Λιμενεργάτες,2014,Σεπτέμβριος,0,0,0,5,5
Σύνολο,Σύνολο,Σύνολο,2014,Σεπτέμβριος,0,9,410,21081,21500
A,1,"Γεωργία, δασοκομία και αλιεία",2014,Οκτώβριος,0,0,0,132,132
B,2,Ορυχεία και λατομεία,2014,Οκτώβριος,0,0,0,26,26
C,3,Μεταποίηση,2014,Οκτώβριος,9,0,1,1663,1673
D,4,"Παροχή ηλεκτρικού ρεύματος, φυσικού αερίου, ατμού και κλιματισμού",2014,Οκτώβριος,0,0,0,26,26
E,5,"Παροχή νερού, επεξεργασία λυμάτων, διαχείριση αποβλήτων και δραστηριότητες εξυγίανσης",2014,Οκτώβριος,0,0,0,12,12
F,6,Κατασκευές,2014,Οκτώβριος,0,2,13,2290,2305
G,7,Χονδρικό και λιανικό εμπόριο.  Επισκευή μηχανοκίνητων οχημάτων και μοτοσυκλετών,2014,Οκτώβριος,0,5,4,3184,3193
H,8,Μεταφορά και αποθήκευση,2014,Οκτώβριος,0,0,1,600,601
I,9,Δραστηριότητες υπηρεσιών παροχής καταλύματος και υπηρεσιών εστίασης,2014,Οκτώβριος,0,2,638,1520,2160
J,10,Ενημέρωση και επικοινωνία,2014,Οκτώβριος,0,0,1,456,457
K,11,Χρηματοπιστωτικές και ασφαλιστικές δραστηριότητες,2014,Οκτώβριος,0,0,0,1031,1031
L,12,Διαχείριση ακίνητης περιουσίας,2014,Οκτώβριος,0,0,8,92,100
M,13,"Επαγγελματικές, επιστημονικές και τεχνικές δραστηριότητες",2014,Οκτώβριος,0,0,0,717,717
N,14,Διοικητικές και υποστηρικτικές δραστηριότητες,2014,Οκτώβριος,0,0,3,360,363
O,15,Δημόσια διοίκηση και άμυνα. Υποχρεωτική κοινωνική ασφάλιση,2014,Οκτώβριος,0,0,0,986,986
P,16,Εκπαίδευση,2014,Οκτώβριος,0,0,0,588,588
Q,17,Δραστηριότητες σχετικές με την ανθρώπινη υγεία και την κοινωνική μέριμνα,2014,Οκτώβριος,0,0,0,285,285
R,18,"Τέχνες, διασκέδαση και ψυχαγωγία",2014,Οκτώβριος,0,0,0,231,231
S,19,Άλλες δραστηριότητες παροχής υπηρεσιών,2014,Οκτώβριος,0,0,11,314,325
T,20,Δραστηριότητες νοικοκυριών ως εργοδοτών,2014,Οκτώβριος,0,0,0,33,33
U,21,Δραστηριότητες ετερόδικων οργανισμών και φορέων,2014,Οκτώβριος,0,0,0,15,15
N/A,22,Μη δηλωμένη οικονομική δραστηριότητα,2014,Οκτώβριος,0,0,4,2674,2678
LIM,23,Λιμενεργάτες,2014,Οκτώβριος,0,0,0,0,0
Σύνολο,Σύνολο,Σύνολο,2014,Οκτώβριος,9,9,684,17235,17937
A,1,"Γεωργία, δασοκομία και αλιεία",2014,Νοέμβριος,0,0,0,114,114
B,2,Ορυχεία και λατομεία,2014,Νοέμβριος,0,0,0,25,25
C,3,Μεταποίηση,2014,Νοέμβριος,43,0,2,1672,1717
D,4,"Παροχή ηλεκτρικού ρεύματος, φυσικού αερίου, ατμού και κλιματισμού",2014,Νοέμβριος,0,0,0,25,25
E,5,"Παροχή νερού, επεξεργασία λυμάτων, διαχείριση αποβλήτων και δραστηριότητες εξυγίανσης",2014,Νοέμβριος,0,0,0,13,13
F,6,Κατασκευές,2014,Νοέμβριος,0,3,15,2199,2217
G,7,Χονδρικό και λιανικό εμπόριο.  Επισκευή μηχανοκίνητων οχημάτων και μοτοσυκλετών,2014,Νοέμβριος,0,170,27,3527,3724
H,8,Μεταφορά και αποθήκευση,2014,Νοέμβριος,0,42,9,972,1023
I,9,Δραστηριότητες υπηρεσιών παροχής καταλύματος και υπηρεσιών εστίασης,2014,Νοέμβριος,0,2093,3924,3240,9257
J,10,Ενημέρωση και επικοινωνία,2014,Νοέμβριος,0,0,1,469,470
K,11,Χρηματοπιστωτικές και ασφαλιστικές δραστηριότητες,2014,Νοέμβριος,0,0,0,711,711
L,12,Διαχείριση ακίνητης περιουσίας,2014,Νοέμβριος,0,0,8,131,139
M,13,"Επαγγελματικές, επιστημονικές και τεχνικές δραστηριότητες",2014,Νοέμβριος,0,1,0,688,689
N,14,Διοικητικές και υποστηρικτικές δραστηριότητες,2014,Νοέμβριος,0,55,22,603,680
O,15,Δημόσια διοίκηση και άμυνα. Υποχρεωτική κοινωνική ασφάλιση,2014,Νοέμβριος,0,14,0,1441,1455
P,16,Εκπαίδευση,2014,Νοέμβριος,0,9,1,380,390
Q,17,Δραστηριότητες σχετικές με την ανθρώπινη υγεία και την κοινωνική μέριμνα,2014,Νοέμβριος,0,0,2,298,300
R,18,"Τέχνες, διασκέδαση και ψυχαγωγία",2014,Νοέμβριος,0,50,6,380,436
S,19,Άλλες δραστηριότητες παροχής υπηρεσιών,2014,Νοέμβριος,0,7,29,364,400
T,20,Δραστηριότητες νοικοκυριών ως εργοδοτών,2014,Νοέμβριος,0,0,0,37,37
U,21,Δραστηριότητες ετερόδικων οργανισμών και φορέων,2014,Νοέμβριος,0,0,0,15,15
N/A,22,Μη δηλωμένη οικονομική δραστηριότητα,2014,Νοέμβριος,0,0,10,1967,1977
LIM,23,Λιμενεργάτες,2014,Νοέμβριος,0,0,0,0,0
Σύνολο,Σύνολο,Σύνολο,2014,Νοέμβριος,43,2444,4056,19271,25814
A,1,"Γεωργία, δασοκομία και αλιεία",2014,Δεκέμβριος,0,0,1,112,113
B,2,Ορυχεία και λατομεία,2014,Δεκέμβριος,0,0,0,25,25
C,3,Μεταποίηση,2014,Δεκέμβριος,46,0,3,1672,1721
D,4,"Παροχή ηλεκτρικού ρεύματος, φυσικού αερίου, ατμού και κλιματισμού",2014,Δεκέμβριος,0,0,0,21,21
E,5,"Παροχή νερού, επεξεργασία λυμάτων, διαχείριση αποβλήτων και δραστηριότητες εξυγίανσης",2014,Δεκέμβριος,0,0,0,9,9
F,6,Κατασκευές,2014,Δεκέμβριος,0,2,17,2129,2148
G,7,Χονδρικό και λιανικό εμπόριο.  Επισκευή μηχανοκίνητων οχημάτων και μοτοσυκλετών,2014,Δεκέμβριος,0,224,32,3626,3882
H,8,Μεταφορά και αποθήκευση,2014,Δεκέμβριος,0,42,12,1099,1153
I,9,Δραστηριότητες υπηρεσιών παροχής καταλύματος και υπηρεσιών εστίασης,2014,Δεκέμβριος,0,3739,4701,3801,12241
J,10,Ενημέρωση και επικοινωνία,2014,Δεκέμβριος,0,0,1,470,471
K,11,Χρηματοπιστωτικές και ασφαλιστικές δραστηριότητες,2014,Δεκέμβριος,0,0,0,601,601
L,12,Διαχείριση ακίνητης περιουσίας,2014,Δεκέμβριος,0,0,8,150,158
M,13,"Επαγγελματικές, επιστημονικές και τεχνικές δραστηριότητες",2014,Δεκέμβριος,0,1,1,697,699
N,14,Διοικητικές και υποστηρικτικές δραστηριότητες,2014,Δεκέμβριος,0,58,37,685,780
O,15,Δημόσια διοίκηση και άμυνα. Υποχρεωτική κοινωνική ασφάλιση,2014,Δεκέμβριος,0,16,0,2152,2168
P,16,Εκπαίδευση,2014,Δεκέμβριος,0,9,3,365,377
Q,17,Δραστηριότητες σχετικές με την ανθρώπινη υγεία και την κοινωνική μέριμνα,2014,Δεκέμβριος,0,0,2,298,300
R,18,"Τέχνες, διασκέδαση και ψυχαγωγία",2014,Δεκέμβριος,0,53,11,407,471
S,19,Άλλες δραστηριότητες παροχής υπηρεσιών,2014,Δεκέμβριος,0,17,32,411,460
T,20,Δραστηριότητες νοικοκυριών ως εργοδοτών,2014,Δεκέμβριος,0,0,0,42,42
U,21,Δραστηριότητες ετερόδικων οργανισμών και φορέων,2014,Δεκέμβριος,0,0,0,15,15
N/A,22,Μη δηλωμένη οικονομική δραστηριότητα,2014,Δεκέμβριος,0,2,18,1762,1782
LIM,23,Λιμενεργάτες,2014,Δεκέμβριος,0,0,0,0,0
Σύνολο,Σύνολο,Σύνολο,2014,Δεκέμβριος,46,4163,4879,20549,29637
A,1,"Γεωργία, δασοκομία και αλιεία",2015,Ιανουάριος,0,0,1,147,148
B,2,Ορυχεία και λατομεία,2015,Ιανουάριος,0,0,0,25,25
C,3,Μεταποίηση,2015,Ιανουάριος,59,0,2,1638,1699
D,4,"Παροχή ηλεκτρικού ρεύματος, φυσικού αερίου, ατμού και κλιματισμού",2015,Ιανουάριος,0,0,0,14,14
E,5,"Παροχή νερού, επεξεργασία λυμάτων, διαχείριση αποβλήτων και δραστηριότητες εξυγίανσης",2015,Ιανουάριος,0,0,0,16,16
F,6,Κατασκευές,2015,Ιανουάριος,0,2,14,2087,2103
G,7,Χονδρικό και λιανικό εμπόριο.  Επισκευή μηχανοκίνητων οχημάτων και μοτοσυκλετών,2015,Ιανουάριος,0,242,34,3738,4014
H,8,Μεταφορά και αποθήκευση,2015,Ιανουάριος,0,40,12,1143,1195
I,9,Δραστηριότητες υπηρεσιών παροχής καταλύματος και υπηρεσιών εστίασης,2015,Ιανουάριος,0,4306,4723,3980,13009
J,10,Ενημέρωση και επικοινωνία,2015,Ιανουάριος,0,0,1,623,624
K,11,Χρηματοπιστωτικές και ασφαλιστικές δραστηριότητες,2015,Ιανουάριος,0,0,0,584,584
L,12,Διαχείριση ακίνητης περιουσίας,2015,Ιανουάριος,0,0,8,176,184
M,13,"Επαγγελματικές, επιστημονικές και τεχνικές δραστηριότητες",2015,Ιανουάριος,0,1,1,726,728
N,14,Διοικητικές και υποστηρικτικές δραστηριότητες,2015,Ιανουάριος,0,60,35,723,818
O,15,Δημόσια διοίκηση και άμυνα. Υποχρεωτική κοινωνική ασφάλιση,2015,Ιανουάριος,0,17,1,2523,2541
P,16,Εκπαίδευση,2015,Ιανουάριος,0,9,3,356,368
Q,17,Δραστηριότητες σχετικές με την ανθρώπινη υγεία και την κοινωνική μέριμνα,2015,Ιανουάριος,0,1,2,307,310
R,18,"Τέχνες, διασκέδαση και ψυχαγωγία",2015,Ιανουάριος,0,55,14,412,481
S,19,Άλλες δραστηριότητες παροχής υπηρεσιών,2015,Ιανουάριος,0,17,30,421,468
T,20,Δραστηριότητες νοικοκυριών ως εργοδοτών,2015,Ιανουάριος,0,0,0,39,39
U,21,Δραστηριότητες ετερόδικων οργανισμών και φορέων,2015,Ιανουάριος,0,0,0,13,13
N/A,22,Μη δηλωμένη οικονομική δραστηριότητα,2015,Ιανουάριος,0,4,18,1832,1854
LIM,23,Λιμενεργάτες,2015,Ιανουάριος,0,0,0,1,1
Σύνολο,Σύνολο,Σύνολο,2015,Ιανουάριος,59,4754,4899,21524,31236
A,1,"Γεωργία, δασοκομία και αλιεία",2015,Φεβρουάριος,0,0,1,143,144
B,2,Ορυχεία και λατομεία,2015,Φεβρουάριος,0,0,0,25,25
C,3,Μεταποίηση,2015,Φεβρουάριος,54,0,3,1628,1685
D,4,"Παροχή ηλεκτρικού ρεύματος, φυσικού αερίου, ατμού και κλιματισμού",2015,Φεβρουάριος,0,0,0,11,11
E,5,"Παροχή νερού, επεξεργασία λυμάτων, διαχείριση αποβλήτων και δραστηριότητες εξυγίανσης",2015,Φεβρουάριος,0,0,0,15,15
F,6,Κατασκευές,2015,Φεβρουάριος,0,2,14,2093,2109
G,7,Χονδρικό και λιανικό εμπόριο.  Επισκευή μηχανοκίνητων οχημάτων και μοτοσυκλετών,2015,Φεβρουάριος,0,243,33,3753,4029
H,8,Μεταφορά και αποθήκευση,2015,Φεβρουάριος,0,40,11,1123,1174
I,9,Δραστηριότητες υπηρεσιών παροχής καταλύματος και υπηρεσιών εστίασης,2015,Φεβρουάριος,0,4323,4609,3978,12910
J,10,Ενημέρωση και επικοινωνία,2015,Φεβρουάριος,0,0,1,617,618
K,11,Χρηματοπιστωτικές και ασφαλιστικές δραστηριότητες,2015,Φεβρουάριος,0,0,0,576,576
L,12,Διαχείριση ακίνητης περιουσίας,2015,Φεβρουάριος,0,0,7,188,195
M,13,"Επαγγελματικές, επιστημονικές και τεχνικές δραστηριότητες",2015,Φεβρουάριος,0,1,1,728,730
N,14,Διοικητικές και υποστηρικτικές δραστηριότητες,2015,Φεβρουάριος,0,59,34,723,816
O,15,Δημόσια διοίκηση και άμυνα. Υποχρεωτική κοινωνική ασφάλιση,2015,Φεβρουάριος,0,17,1,2365,2383
P,16,Εκπαίδευση,2015,Φεβρουάριος,0,9,3,328,340
Q,17,Δραστηριότητες σχετικές με την ανθρώπινη υγεία και την κοινωνική μέριμνα,2015,Φεβρουάριος,0,2,1,310,313
R,18,"Τέχνες, διασκέδαση και ψυχαγωγία",2015,Φεβρουάριος,0,57,13,418,488
S,19,Άλλες δραστηριότητες παροχής υπηρεσιών,2015,Φεβρουάριος,0,22,30,413,465
T,20,Δραστηριότητες νοικοκυριών ως εργοδοτών,2015,Φεβρουάριος,0,0,0,42,42
U,21,Δραστηριότητες ετερόδικων οργανισμών και φορέων,2015,Φεβρουάριος,0,0,0,11,11
N/A,22,Μη δηλωμένη οικονομική δραστηριότητα,2015,Φεβρουάριος,0,6,18,1796,1820
LIM,23,Λιμενεργάτες,2015,Φεβρουάριος,0,0,0,1,1
Σύνολο,Σύνολο,Σύνολο,2015,Φεβρουάριος,54,4781,4780,21285,30900
A,1,"Γεωργία, δασοκομία και αλιεία",2015,Μάρτιος,0,0,1,139,140
B,2,Ορυχεία και λατομεία,2015,Μάρτιος,0,0,0,27,27
C,3,Μεταποίηση,2015,Μάρτιος,48,0,3,1567,1618
D,4,"Παροχή ηλεκτρικού ρεύματος, φυσικού αερίου, ατμού και κλιματισμού",2015,Μάρτιος,0,0,0,12,12
E,5,"Παροχή νερού, επεξεργασία λυμάτων, διαχείριση αποβλήτων και δραστηριότητες εξυγίανσης",2015,Μάρτιος,0,0,0,13,13
F,6,Κατασκευές,2015,Μάρτιος,0,2,12,2075,2089
G,7,Χονδρικό και λιανικό εμπόριο.  Επισκευή μηχανοκίνητων οχημάτων και μοτοσυκλετών,2015,Μάρτιος,0,236,32,3826,4094
H,8,Μεταφορά και αποθήκευση,2015,Μάρτιος,0,39,11,1465,1515
I,9,Δραστηριότητες υπηρεσιών παροχής καταλύματος και υπηρεσιών εστίασης,2015,Μάρτιος,0,3806,4444,3891,12141
J,10,Ενημέρωση και επικοινωνία,2015,Μάρτιος,0,0,1,596,597
K,11,Χρηματοπιστωτικές και ασφαλιστικές δραστηριότητες,2015,Μάρτιος,0,1,0,561,562
L,12,Διαχείριση ακίνητης περιουσίας,2015,Μάρτιος,0,0,4,153,157
M,13,"Επαγγελματικές, επιστημονικές και τεχνικές δραστηριότητες",2015,Μάρτιος,0,1,1,715,717
N,14,Διοικητικές και υποστηρικτικές δραστηριότητες,2015,Μάρτιος,0,58,34,700,792
O,15,Δημόσια διοίκηση και άμυνα. Υποχρεωτική κοινωνική ασφάλιση,2015,Μάρτιος,0,17,1,2385,2403
P,16,Εκπαίδευση,2015,Μάρτιος,0,9,3,310,322
Q,17,Δραστηριότητες σχετικές με την ανθρώπινη υγεία και την κοινωνική μέριμνα,2015,Μάρτιος,0,2,1,313,316
R,18,"Τέχνες, διασκέδαση και ψυχαγωγία",2015,Μάρτιος,0,55,14,404,473
S,19,Άλλες δραστηριότητες παροχής υπηρεσιών,2015,Μάρτιος,0,12,30,400,442
T,20,Δραστηριότητες νοικοκυριών ως εργοδοτών,2015,Μάρτιος,0,0,0,43,43
U,21,Δραστηριότητες ετερόδικων οργανισμών και φορέων,2015,Μάρτιος,0,0,0,20,20
N/A,22,Μη δηλωμένη οικονομική δραστηριότητα,2015,Μάρτιος,0,6,18,1787,1811
LIM,23,Λιμενεργάτες,2015,Μάρτιος,0,0,0,10,10
Σύνολο,Σύνολο,Σύνολο,2015,Μάρτιος,48,4244,4610,21412,30314
A,1,"Γεωργία, δασοκομία και αλιεία",2015,Απρίλιος,0,0,2,152,154
B,2,Ορυχεία και λατομεία,2015,Απρίλιος,0,0,0,26,26
C,3,Μεταποίηση,2015,Απρίλιος,10,0,2,1455,1467
D,4,"Παροχή ηλεκτρικού ρεύματος, φυσικού αερίου, ατμού και κλιματισμού",2015,Απρίλιος,0,0,0,52,52
E,5,"Παροχή νερού, επεξεργασία λυμάτων, διαχείριση αποβλήτων και δραστηριότητες εξυγίανσης",2015,Απρίλιος,0,0,0,9,9
F,6,Κατασκευές,2015,Απρίλιος,0,0,12,1977,1989
G,7,Χονδρικό και λιανικό εμπόριο.  Επισκευή μηχανοκίνητων οχημάτων και μοτοσυκλετών,2015,Απρίλιος,0,0,24,3677,3701
H,8,Μεταφορά και αποθήκευση,2015,Απρίλιος,0,1,10,1305,1316
I,9,Δραστηριότητες υπηρεσιών παροχής καταλύματος και υπηρεσιών εστίασης,2015,Απρίλιος,0,38,3188,3189,6415
J,10,Ενημέρωση και επικοινωνία,2015,Απρίλιος,0,0,1,577,578
K,11,Χρηματοπιστωτικές και ασφαλιστικές δραστηριότητες,2015,Απρίλιος,0,1,0,556,557
L,12,Διαχείριση ακίνητης περιουσίας,2015,Απρίλιος,0,0,2,126,128
M,13,"Επαγγελματικές, επιστημονικές και τεχνικές δραστηριότητες",2015,Απρίλιος,0,0,1,696,697
N,14,Διοικητικές και υποστηρικτικές δραστηριότητες,2015,Απρίλιος,0,0,27,619,646
O,15,Δημόσια διοίκηση και άμυνα. Υποχρεωτική κοινωνική ασφάλιση,2015,Απρίλιος,0,1,1,2084,2086
P,16,Εκπαίδευση,2015,Απρίλιος,0,0,2,302,304
Q,17,Δραστηριότητες σχετικές με την ανθρώπινη υγεία και την κοινωνική μέριμνα,2015,Απρίλιος,0,2,0,299,301
R,18,"Τέχνες, διασκέδαση και ψυχαγωγία",2015,Απρίλιος,0,2,11,381,394
S,19,Άλλες δραστηριότητες παροχής υπηρεσιών,2015,Απρίλιος,0,0,22,369,391
T,20,Δραστηριότητες νοικοκυριών ως εργοδοτών,2015,Απρίλιος,0,0,0,45,45
U,21,Δραστηριότητες ετερόδικων οργανισμών και φορέων,2015,Απρίλιος,0,0,0,20,20
N/A,22,Μη δηλωμένη οικονομική δραστηριότητα,2015,Απρίλιος,0,0,11,1692,1703
LIM,23,Λιμενεργάτες,2015,Απρίλιος,0,0,0,9,9
Σύνολο,Σύνολο,Σύνολο,2015,Απρίλιος,10,45,3316,19617,22988
A,1,"Γεωργία, δασοκομία και αλιεία",2015,Μάιος,0,0,2,147,149
B,2,Ορυχεία και λατομεία,2015,Μάιος,0,0,0,26,26
C,3,Μεταποίηση,2015,Μάιος,3,0,0,1370,1373
D,4,"Παροχή ηλεκτρικού ρεύματος, φυσικού αερίου, ατμού και κλιματισμού",2015,Μάιος,0,0,0,66,66
E,5,"Παροχή νερού, επεξεργασία λυμάτων, διαχείριση αποβλήτων και δραστηριότητες εξυγίανσης",2015,Μάιος,0,0,0,7,7
F,6,Κατασκευές,2015,Μάιος,0,0,12,1934,1946
G,7,Χονδρικό και λιανικό εμπόριο.  Επισκευή μηχανοκίνητων οχημάτων και μοτοσυκλετών,2015,Μάιος,0,0,12,3346,3358
H,8,Μεταφορά και αποθήκευση,2015,Μάιος,0,0,5,1041,1046
I,9,Δραστηριότητες υπηρεσιών παροχής καταλύματος και υπηρεσιών εστίασης,2015,Μάιος,0,5,1151,2022,3178
J,10,Ενημέρωση και επικοινωνία,2015,Μάιος,0,0,1,560,561
K,11,Χρηματοπιστωτικές και ασφαλιστικές δραστηριότητες,2015,Μάιος,0,0,0,536,536
L,12,Διαχείριση ακίνητης περιουσίας,2015,Μάιος,0,0,2,98,100
M,13,"Επαγγελματικές, επιστημονικές και τεχνικές δραστηριότητες",2015,Μάιος,0,0,0,679,679
N,14,Διοικητικές και υποστηρικτικές δραστηριότητες,2015,Μάιος,0,0,10,452,462
O,15,Δημόσια διοίκηση και άμυνα. Υποχρεωτική κοινωνική ασφάλιση,2015,Μάιος,0,0,0,1138,1138
P,16,Εκπαίδευση,2015,Μάιος,0,0,0,383,383
Q,17,Δραστηριότητες σχετικές με την ανθρώπινη υγεία και την κοινωνική μέριμνα,2015,Μάιος,0,1,0,262,263
R,18,"Τέχνες, διασκέδαση και ψυχαγωγία",2015,Μάιος,0,0,4,268,272
S,19,Άλλες δραστηριότητες παροχής υπηρεσιών,2015,Μάιος,0,0,14,299,313
T,20,Δραστηριότητες νοικοκυριών ως εργοδοτών,2015,Μάιος,0,0,0,38,38
U,21,Δραστηριότητες ετερόδικων οργανισμών και φορέων,2015,Μάιος,0,0,0,23,23
N/A,22,Μη δηλωμένη οικονομική δραστηριότητα,2015,Μάιος,0,1,7,1702,1710
LIM,23,Λιμενεργάτες,2015,Μάιος,0,0,0,10,10
Σύνολο,Σύνολο,Σύνολο,2015,Μάιος,3,7,1220,16407,17637
A,1,"Γεωργία, δασοκομία και αλιεία",2015,Ιούνιος,0,0,1,140,141
B,2,Ορυχεία και λατομεία,2015,Ιούνιος,0,0,0,27,27
C,3,Μεταποίηση,2015,Ιούνιος,0,0,0,1279,1279
D,4,"Παροχή ηλεκτρικού ρεύματος, φυσικού αερίου, ατμού και κλιματισμού",2015,Ιούνιος,0,0,0,72,72
E,5,"Παροχή νερού, επεξεργασία λυμάτων, διαχείριση αποβλήτων και δραστηριότητες εξυγίανσης",2015,Ιούνιος,0,0,0,6,6
F,6,Κατασκευές,2015,Ιούνιος,0,0,9,1843,1852
G,7,Χονδρικό και λιανικό εμπόριο.  Επισκευή μηχανοκίνητων οχημάτων και μοτοσυκλετών,2015,Ιούνιος,0,0,8,3157,3165
H,8,Μεταφορά και αποθήκευση,2015,Ιούνιος,0,0,1,954,955
I,9,Δραστηριότητες υπηρεσιών παροχής καταλύματος και υπηρεσιών εστίασης,2015,Ιούνιος,0,2,460,1723,2185
J,10,Ενημέρωση και επικοινωνία,2015,Ιούνιος,0,0,1,533,534
K,11,Χρηματοπιστωτικές και ασφαλιστικές δραστηριότητες,2015,Ιούνιος,0,0,0,492,492
L,12,Διαχείριση ακίνητης περιουσίας,2015,Ιούνιος,0,0,1,85,86
M,13,"Επαγγελματικές, επιστημονικές και τεχνικές δραστηριότητες",2015,Ιούνιος,0,0,0,717,717
N,14,Διοικητικές και υποστηρικτικές δραστηριότητες,2015,Ιούνιος,0,0,7,397,404
O,15,Δημόσια διοίκηση και άμυνα. Υποχρεωτική κοινωνική ασφάλιση,2015,Ιούνιος,0,0,0,1533,1533
P,16,Εκπαίδευση,2015,Ιούνιος,0,0,0,1283,1283
Q,17,Δραστηριότητες σχετικές με την ανθρώπινη υγεία και την κοινωνική μέριμνα,2015,Ιούνιος,0,0,0,254,254
R,18,"Τέχνες, διασκέδαση και ψυχαγωγία",2015,Ιούνιος,0,0,4,251,255
S,19,Άλλες δραστηριότητες παροχής υπηρεσιών,2015,Ιούνιος,0,0,9,345,354
T,20,Δραστηριότητες νοικοκυριών ως εργοδοτών,2015,Ιούνιος,0,0,0,40,40
U,21,Δραστηριότητες ετερόδικων οργανισμών και φορέων,2015,Ιούνιος,0,0,0,26,26
N/A,22,Μη δηλωμένη οικονομική δραστηριότητα,2015,Ιούνιος,0,1,7,2163,2171
LIM,23,Λιμενεργάτες,2015,Ιούνιος,0,0,0,11,11
Σύνολο,Σύνολο,Σύνολο,2015,Ιούνιος,0,3,508,17331,17842
A,1,"Γεωργία, δασοκομία και αλιεία",2015,Ιούλιος,0,0,0,124,124
B,2,Ορυχεία και λατομεία,2015,Ιούλιος,0,0,0,29,29
C,3,Μεταποίηση,2015,Ιούλιος,0,0,1,1243,1244
D,4,"Παροχή ηλεκτρικού ρεύματος, φυσικού αερίου, ατμού και κλιματισμού",2015,Ιούλιος,0,0,0,67,67
E,5,"Παροχή νερού, επεξεργασία λυμάτων, διαχείριση αποβλήτων και δραστηριότητες εξυγίανσης",2015,Ιούλιος,0,0,0,6,6
F,6,Κατασκευές,2015,Ιούλιος,0,0,7,1796,1803
G,7,Χονδρικό και λιανικό εμπόριο.  Επισκευή μηχανοκίνητων οχημάτων και μοτοσυκλετών,2015,Ιούλιος,0,0,7,3079,3086
H,8,Μεταφορά και αποθήκευση,2015,Ιούλιος,0,0,1,879,880
I,9,Δραστηριότητες υπηρεσιών παροχής καταλύματος και υπηρεσιών εστίασης,2015,Ιούλιος,0,0,298,1517,1815
J,10,Ενημέρωση και επικοινωνία,2015,Ιούλιος,0,0,0,488,488
K,11,Χρηματοπιστωτικές και ασφαλιστικές δραστηριότητες,2015,Ιούλιος,0,0,0,442,442
L,12,Διαχείριση ακίνητης περιουσίας,2015,Ιούλιος,0,0,2,73,75
M,13,"Επαγγελματικές, επιστημονικές και τεχνικές δραστηριότητες",2015,Ιούλιος,0,0,0,753,753
N,14,Διοικητικές και υποστηρικτικές δραστηριότητες,2015,Ιούλιος,0,0,4,359,363
O,15,Δημόσια διοίκηση και άμυνα. Υποχρεωτική κοινωνική ασφάλιση,2015,Ιούλιος,0,0,0,1734,1734
P,16,Εκπαίδευση,2015,Ιούλιος,0,0,0,2242,2242
Q,17,Δραστηριότητες σχετικές με την ανθρώπινη υγεία και την κοινωνική μέριμνα,2015,Ιούλιος,0,0,1,260,261
R,18,"Τέχνες, διασκέδαση και ψυχαγωγία",2015,Ιούλιος,0,0,3,251,254
S,19,Άλλες δραστηριότητες παροχής υπηρεσιών,2015,Ιούλιος,0,0,4,399,403
T,20,Δραστηριότητες νοικοκυριών ως εργοδοτών,2015,Ιούλιος,0,0,0,38,38
U,21,Δραστηριότητες ετερόδικων οργανισμών και φορέων,2015,Ιούλιος,0,0,0,23,23
N/A,22,Μη δηλωμένη οικονομική δραστηριότητα,2015,Ιούλιος,0,1,8,2107,2116
LIM,23,Λιμενεργάτες,2015,Ιούλιος,0,0,0,7,7
Σύνολο,Σύνολο,Σύνολο,2015,Ιούλιος,0,1,336,17916,18253
A,1,"Γεωργία, δασοκομία και αλιεία",2015,Αύγουστος,0,0,0,120,120
B,2,Ορυχεία και λατομεία,2015,Αύγουστος,0,0,0,23,23
C,3,Μεταποίηση,2015,Αύγουστος,0,0,0,1226,1226
D,4,"Παροχή ηλεκτρικού ρεύματος, φυσικού αερίου, ατμού και κλιματισμού",2015,Αύγουστος,0,0,0,64,64
E,5,"Παροχή νερού, επεξεργασία λυμάτων, διαχείριση αποβλήτων και δραστηριότητες εξυγίανσης",2015,Αύγουστος,0,0,0,5,5
F,6,Κατασκευές,2015,Αύγουστος,0,0,6,1658,1664
G,7,Χονδρικό και λιανικό εμπόριο.  Επισκευή μηχανοκίνητων οχημάτων και μοτοσυκλετών,2015,Αύγουστος,0,0,5,2980,2985
H,8,Μεταφορά και αποθήκευση,2015,Αύγουστος,0,0,1,827,828
I,9,Δραστηριότητες υπηρεσιών παροχής καταλύματος και υπηρεσιών εστίασης,2015,Αύγουστος,0,0,247,1433,1680
J,10,Ενημέρωση και επικοινωνία,2015,Αύγουστος,0,0,0,450,450
K,11,Χρηματοπιστωτικές και ασφαλιστικές δραστηριότητες,2015,Αύγουστος,0,0,0,379,379
L,12,Διαχείριση ακίνητης περιουσίας,2015,Αύγουστος,0,0,1,68,69
M,13,"Επαγγελματικές, επιστημονικές και τεχνικές δραστηριότητες",2015,Αύγουστος,0,0,1,759,760
N,14,Διοικητικές και υποστηρικτικές δραστηριότητες,2015,Αύγουστος,0,0,2,348,350
O,15,Δημόσια διοίκηση και άμυνα. Υποχρεωτική κοινωνική ασφάλιση,2015,Αύγουστος,0,0,0,1751,1751
P,16,Εκπαίδευση,2015,Αύγουστος,0,0,0,2346,2346
Q,17,Δραστηριότητες σχετικές με την ανθρώπινη υγεία και την κοινωνική μέριμνα,2015,Αύγουστος,0,0,1,273,274
R,18,"Τέχνες, διασκέδαση και ψυχαγωγία",2015,Αύγουστος,0,0,1,242,243
S,19,Άλλες δραστηριότητες παροχής υπηρεσιών,2015,Αύγουστος,0,0,2,401,403
T,20,Δραστηριότητες νοικοκυριών ως εργοδοτών,2015,Αύγουστος,0,0,0,33,33
U,21,Δραστηριότητες ετερόδικων οργανισμών και φορέων,2015,Αύγουστος,0,0,0,25,25
N/A,22,Μη δηλωμένη οικονομική δραστηριότητα,2015,Αύγουστος,0,1,8,2066,2075
LIM,23,Λιμενεργάτες,2015,Αύγουστος,0,0,0,6,6
Σύνολο,Σύνολο,Σύνολο,2015,Αύγουστος,0,1,275,17483,17759
A,1,"Γεωργία, δασοκομία και αλιεία",2015,Σεπτέμβριος,0,0,0,119,119
B,2,Ορυχεία και λατομεία,2015,Σεπτέμβριος,0,0,0,26,26
C,3,Μεταποίηση,2015,Σεπτέμβριος,19,0,0,1256,1275
D,4,"Παροχή ηλεκτρικού ρεύματος, φυσικού αερίου, ατμού και κλιματισμού",2015,Σεπτέμβριος,0,0,0,63,63
E,5,"Παροχή νερού, επεξεργασία λυμάτων, διαχείριση αποβλήτων και δραστηριότητες εξυγίανσης",2015,Σεπτέμβριος,0,0,0,4,4
F,6,Κατασκευές,2015,Σεπτέμβριος,0,0,9,1612,1621
G,7,Χονδρικό και λιανικό εμπόριο.  Επισκευή μηχανοκίνητων οχημάτων και μοτοσυκλετών,2015,Σεπτέμβριος,0,0,6,2986,2992
H,8,Μεταφορά και αποθήκευση,2015,Σεπτέμβριος,0,0,2,785,787
I,9,Δραστηριότητες υπηρεσιών παροχής καταλύματος και υπηρεσιών εστίασης,2015,Σεπτέμβριος,0,0,259,1425,1684
J,10,Ενημέρωση και επικοινωνία,2015,Σεπτέμβριος,0,0,0,404,404
K,11,Χρηματοπιστωτικές και ασφαλιστικές δραστηριότητες,2015,Σεπτέμβριος,0,0,0,362,362
L,12,Διαχείριση ακίνητης περιουσίας,2015,Σεπτέμβριος,0,0,2,72,74
M,13,"Επαγγελματικές, επιστημονικές και τεχνικές δραστηριότητες",2015,Σεπτέμβριος,0,0,1,743,744
N,14,Διοικητικές και υποστηρικτικές δραστηριότητες,2015,Σεπτέμβριος,0,0,1,350,351
O,15,Δημόσια διοίκηση και άμυνα. Υποχρεωτική κοινωνική ασφάλιση,2015,Σεπτέμβριος,0,0,0,1332,1332
P,16,Εκπαίδευση,2015,Σεπτέμβριος,0,0,0,1341,1341
Q,17,Δραστηριότητες σχετικές με την ανθρώπινη υγεία και την κοινωνική μέριμνα,2015,Σεπτέμβριος,0,0,1,274,275
R,18,"Τέχνες, διασκέδαση και ψυχαγωγία",2015,Σεπτέμβριος,0,0,2,227,229
S,19,Άλλες δραστηριότητες παροχής υπηρεσιών,2015,Σεπτέμβριος,0,0,2,341,343
T,20,Δραστηριότητες νοικοκυριών ως εργοδοτών,2015,Σεπτέμβριος,0,0,0,28,28
U,21,Δραστηριότητες ετερόδικων οργανισμών και φορέων,2015,Σεπτέμβριος,0,0,0,23,23
N/A,22,Μη δηλωμένη οικονομική δραστηριότητα,2015,Σεπτέμβριος,0,0,6,2045,2051
LIM,23,Λιμενεργάτες,2015,Σεπτέμβριος,0,0,0,4,4
Σύνολο,Σύνολο,Σύνολο,2015,Σεπτέμβριος,19,0,291,15822,16132
A,1,"Γεωργία, δασοκομία και αλιεία",2015,Οκτώβριος,0,0,0,122,122
B,2,Ορυχεία και λατομεία,2015,Οκτώβριος,0,0,0,23,23
C,3,Μεταποίηση,2015,Οκτώβριος,25,0,0,1240,1265
D,4,"Παροχή ηλεκτρικού ρεύματος, φυσικού αερίου, ατμού και κλιματισμού",2015,Οκτώβριος,0,0,0,65,65
E,5,"Παροχή νερού, επεξεργασία λυμάτων, διαχείριση αποβλήτων και δραστηριότητες εξυγίανσης",2015,Οκτώβριος,0,0,0,5,5
F,6,Κατασκευές,2015,Οκτώβριος,0,0,10,1536,1546
G,7,Χονδρικό και λιανικό εμπόριο.  Επισκευή μηχανοκίνητων οχημάτων και μοτοσυκλετών,2015,Οκτώβριος,0,0,5,2973,2978
H,8,Μεταφορά και αποθήκευση,2015,Οκτώβριος,0,0,2,718,720
I,9,Δραστηριότητες υπηρεσιών παροχής καταλύματος και υπηρεσιών εστίασης,2015,Οκτώβριος,0,0,460,1526,1986
J,10,Ενημέρωση και επικοινωνία,2015,Οκτώβριος,0,0,0,356,356
K,11,Χρηματοπιστωτικές και ασφαλιστικές δραστηριότητες,2015,Οκτώβριος,0,0,0,339,339
L,12,Διαχείριση ακίνητης περιουσίας,2015,Οκτώβριος,0,0,3,79,82
M,13,"Επαγγελματικές, επιστημονικές και τεχνικές δραστηριότητες",2015,Οκτώβριος,0,0,1,738,739
N,14,Διοικητικές και υποστηρικτικές δραστηριότητες,2015,Οκτώβριος,0,0,2,362,364
O,15,Δημόσια διοίκηση και άμυνα. Υποχρεωτική κοινωνική ασφάλιση,2015,Οκτώβριος,0,0,0,513,513
P,16,Εκπαίδευση,2015,Οκτώβριος,0,0,0,527,527
Q,17,Δραστηριότητες σχετικές με την ανθρώπινη υγεία και την κοινωνική μέριμνα,2015,Οκτώβριος,0,0,1,257,258
R,18,"Τέχνες, διασκέδαση και ψυχαγωγία",2015,Οκτώβριος,0,0,2,224,226
S,19,Άλλες δραστηριότητες παροχής υπηρεσιών,2015,Οκτώβριος,0,0,14,264,278
T,20,Δραστηριότητες νοικοκυριών ως εργοδοτών,2015,Οκτώβριος,0,0,0,27,27
U,21,Δραστηριότητες ετερόδικων οργανισμών και φορέων,2015,Οκτώβριος,0,0,0,16,16
N/A,22,Μη δηλωμένη οικονομική δραστηριότητα,2015,Οκτώβριος,0,0,5,1691,1696
LIM,23,Λιμενεργάτες,2015,Οκτώβριος,0,0,0,1,1
Σύνολο,Σύνολο,Σύνολο,2015,Οκτώβριος,25,0,505,13602,14132
A,1,"Γεωργία, δασοκομία και αλιεία",2015,Νοέμβριος,0,0,0,124,124
B,2,Ορυχεία και λατομεία,2015,Νοέμβριος,0,0,0,23,23
C,3,Μεταποίηση,2015,Νοέμβριος,32,0,1,1270,1303
D,4,"Παροχή ηλεκτρικού ρεύματος, φυσικού αερίου, ατμού και κλιματισμού",2015,Νοέμβριος,0,0,0,61,61
E,5,"Παροχή νερού, επεξεργασία λυμάτων, διαχείριση αποβλήτων και δραστηριότητες εξυγίανσης",2015,Νοέμβριος,0,0,0,4,4
F,6,Κατασκευές,2015,Νοέμβριος,0,0,17,1458,1475
G,7,Χονδρικό και λιανικό εμπόριο.  Επισκευή μηχανοκίνητων οχημάτων και μοτοσυκλετών,2015,Νοέμβριος,0,172,33,3416,3621
H,8,Μεταφορά και αποθήκευση,2015,Νοέμβριος,0,35,10,1190,1235
I,9,Δραστηριότητες υπηρεσιών παροχής καταλύματος και υπηρεσιών εστίασης,2015,Νοέμβριος,0,1996,4140,3065,9201
J,10,Ενημέρωση και επικοινωνία,2015,Νοέμβριος,0,0,0,353,353
K,11,Χρηματοπιστωτικές και ασφαλιστικές δραστηριότητες,2015,Νοέμβριος,0,0,0,330,330
L,12,Διαχείριση ακίνητης περιουσίας,2015,Νοέμβριος,0,0,15,128,143
M,13,"Επαγγελματικές, επιστημονικές και τεχνικές δραστηριότητες",2015,Νοέμβριος,0,0,1,754,755
N,14,Διοικητικές και υποστηρικτικές δραστηριότητες,2015,Νοέμβριος,0,51,19,618,688
O,15,Δημόσια διοίκηση και άμυνα. Υποχρεωτική κοινωνική ασφάλιση,2015,Νοέμβριος,0,11,0,772,783
P,16,Εκπαίδευση,2015,Νοέμβριος,0,7,0,367,374
Q,17,Δραστηριότητες σχετικές με την ανθρώπινη υγεία και την κοινωνική μέριμνα,2015,Νοέμβριος,0,0,1,277,278
R,18,"Τέχνες, διασκέδαση και ψυχαγωγία",2015,Νοέμβριος,0,42,8,374,424
S,19,Άλλες δραστηριότητες παροχής υπηρεσιών,2015,Νοέμβριος,0,6,32,336,374
T,20,Δραστηριότητες νοικοκυριών ως εργοδοτών,2015,Νοέμβριος,0,0,0,26,26
U,21,Δραστηριότητες ετερόδικων οργανισμών και φορέων,2015,Νοέμβριος,0,0,0,15,15
N/A,22,Μη δηλωμένη οικονομική δραστηριότητα,2015,Νοέμβριος,0,2,64,1551,1617
LIM,23,Λιμενεργάτες,2015,Νοέμβριος,0,0,0,7,7
Σύνολο,Σύνολο,Σύνολο,2015,Νοέμβριος,32,2322,4341,16519,23214
A,1,"Γεωργία, δασοκομία και αλιεία",2015,Δεκέμβριος,0,0,0,117,117
B,2,Ορυχεία και λατομεία,2015,Δεκέμβριος,0,0,0,23,23
C,3,Μεταποίηση,2015,Δεκέμβριος,22,0,4,1224,1250
D,4,"Παροχή ηλεκτρικού ρεύματος, φυσικού αερίου, ατμού και κλιματισμού",2015,Δεκέμβριος,0,0,0,47,47
E,5,"Παροχή νερού, επεξεργασία λυμάτων, διαχείριση αποβλήτων και δραστηριότητες εξυγίανσης",2015,Δεκέμβριος,0,0,0,4,4
F,6,Κατασκευές,2015,Δεκέμβριος,0,1,19,1336,1356
G,7,Χονδρικό και λιανικό εμπόριο.  Επισκευή μηχανοκίνητων οχημάτων και μοτοσυκλετών,2015,Δεκέμβριος,0,225,43,3387,3655
H,8,Μεταφορά και αποθήκευση,2015,Δεκέμβριος,0,42,12,1278,1332
I,9,Δραστηριότητες υπηρεσιών παροχής καταλύματος και υπηρεσιών εστίασης,2015,Δεκέμβριος,0,3589,5042,3358,11989
J,10,Ενημέρωση και επικοινωνία,2015,Δεκέμβριος,0,0,0,333,333
K,11,Χρηματοπιστωτικές και ασφαλιστικές δραστηριότητες,2015,Δεκέμβριος,0,0,0,295,295
L,12,Διαχείριση ακίνητης περιουσίας,2015,Δεκέμβριος,0,9,21,145,175
M,13,"Επαγγελματικές, επιστημονικές και τεχνικές δραστηριότητες",2015,Δεκέμβριος,0,0,1,725,726
N,14,Διοικητικές και υποστηρικτικές δραστηριότητες,2015,Δεκέμβριος,0,53,21,703,777
O,15,Δημόσια διοίκηση και άμυνα. Υποχρεωτική κοινωνική ασφάλιση,2015,Δεκέμβριος,0,16,1,1758,1775
P,16,Εκπαίδευση,2015,Δεκέμβριος,0,9,1,319,329
Q,17,Δραστηριότητες σχετικές με την ανθρώπινη υγεία και την κοινωνική μέριμνα,2015,Δεκέμβριος,0,0,2,272,274
R,18,"Τέχνες, διασκέδαση και ψυχαγωγία",2015,Δεκέμβριος,0,44,7,385,436
S,19,Άλλες δραστηριότητες παροχής υπηρεσιών,2015,Δεκέμβριος,0,15,36,372,423
T,20,Δραστηριότητες νοικοκυριών ως εργοδοτών,2015,Δεκέμβριος,0,0,0,30,30
U,21,Δραστηριότητες ετερόδικων οργανισμών και φορέων,2015,Δεκέμβριος,0,0,0,17,17
N/A,22,Μη δηλωμένη οικονομική δραστηριότητα,2015,Δεκέμβριος,0,6,70,1501,1577
LIM,23,Λιμενεργάτες,2015,Δεκέμβριος,0,0,0,3,3
Σύνολο,Σύνολο,Σύνολο,2015,Δεκέμβριος,22,4009,5280,17632,26943
A,1,"Γεωργία, δασοκομία και αλιεία",2016,Ιανουάριος,0,0,0,126,126
B,2,Ορυχεία και λατομεία,2016,Ιανουάριος,0,0,0,18,18
C,3,Μεταποίηση,2016,Ιανουάριος,33,0,5,1217,1255
D,4,"Παροχή ηλεκτρικού ρεύματος, φυσικού αερίου, ατμού και κλιματισμού",2016,Ιανουάριος,0,0,0,40,40
E,5,"Παροχή νερού, επεξεργασία λυμάτων, διαχείριση αποβλήτων και δραστηριότητες εξυγίανσης",2016,Ιανουάριος,0,0,0,6,6
F,6,Κατασκευές,2016,Ιανουάριος,0,1,20,1296,1317
G,7,Χονδρικό και λιανικό εμπόριο.  Επισκευή μηχανοκίνητων οχημάτων και μοτοσυκλετών,2016,Ιανουάριος,0,236,46,3475,3757
H,8,Μεταφορά και αποθήκευση,2016,Ιανουάριος,0,40,12,1291,1343
I,9,Δραστηριότητες υπηρεσιών παροχής καταλύματος και υπηρεσιών εστίασης,2016,Ιανουάριος,0,4177,5098,3440,12715
J,10,Ενημέρωση και επικοινωνία,2016,Ιανουάριος,0,0,0,335,335
K,11,Χρηματοπιστωτικές και ασφαλιστικές δραστηριότητες,2016,Ιανουάριος,0,0,0,310,310
L,12,Διαχείριση ακίνητης περιουσίας,2016,Ιανουάριος,0,10,25,172,207
M,13,"Επαγγελματικές, επιστημονικές και τεχνικές δραστηριότητες",2016,Ιανουάριος,0,0,1,756,757
N,14,Διοικητικές και υποστηρικτικές δραστηριότητες,2016,Ιανουάριος,0,54,22,733,809
O,15,Δημόσια διοίκηση και άμυνα. Υποχρεωτική κοινωνική ασφάλιση,2016,Ιανουάριος,0,17,1,1948,1966
P,16,Εκπαίδευση,2016,Ιανουάριος,0,9,2,319,330
Q,17,Δραστηριότητες σχετικές με την ανθρώπινη υγεία και την κοινωνική μέριμνα,2016,Ιανουάριος,0,0,2,277,279
R,18,"Τέχνες, διασκέδαση και ψυχαγωγία",2016,Ιανουάριος,0,47,7,386,440
S,19,Άλλες δραστηριότητες παροχής υπηρεσιών,2016,Ιανουάριος,0,17,34,377,428
T,20,Δραστηριότητες νοικοκυριών ως εργοδοτών,2016,Ιανουάριος,0,0,0,27,27
U,21,Δραστηριότητες ετερόδικων οργανισμών και φορέων,2016,Ιανουάριος,0,0,0,20,20
N/A,22,Μη δηλωμένη οικονομική δραστηριότητα,2016,Ιανουάριος,0,10,83,1536,1629
LIM,23,Λιμενεργάτες,2016,Ιανουάριος,0,0,0,6,6
Σύνολο,Σύνολο,Σύνολο,2016,Ιανουάριος,33,4618,5358,18111,28120
A,1,"Γεωργία, δασοκομία και αλιεία",2016,Φεβρουάριος,0,0,0,115,115
B,2,Ορυχεία και λατομεία,2016,Φεβρουάριος,0,0,0,19,19
C,3,Μεταποίηση,2016,Φεβρουάριος,49,0,5,1204,1258
D,4,"Παροχή ηλεκτρικού ρεύματος, φυσικού αερίου, ατμού και κλιματισμού",2016,Φεβρουάριος,0,0,0,33,33
E,5,"Παροχή νερού, επεξεργασία λυμάτων, διαχείριση αποβλήτων και δραστηριότητες εξυγίανσης",2016,Φεβρουάριος,0,0,0,7,7
F,6,Κατασκευές,2016,Φεβρουάριος,0,1,20,1273,1294
G,7,Χονδρικό και λιανικό εμπόριο.  Επισκευή μηχανοκίνητων οχημάτων και μοτοσυκλετών,2016,Φεβρουάριος,0,231,46,3516,3793
H,8,Μεταφορά και αποθήκευση,2016,Φεβρουάριος,0,38,10,1263,1311
I,9,Δραστηριότητες υπηρεσιών παροχής καταλύματος και υπηρεσιών εστίασης,2016,Φεβρουάριος,0,4295,4910,3456,12661
J,10,Ενημέρωση και επικοινωνία,2016,Φεβρουάριος,0,0,0,299,299
K,11,Χρηματοπιστωτικές και ασφαλιστικές δραστηριότητες,2016,Φεβρουάριος,0,0,0,324,324
L,12,Διαχείριση ακίνητης περιουσίας,2016,Φεβρουάριος,0,10,24,185,219
M,13,"Επαγγελματικές, επιστημονικές και τεχνικές δραστηριότητες",2016,Φεβρουάριος,0,0,1,739,740
N,14,Διοικητικές και υποστηρικτικές δραστηριότητες,2016,Φεβρουάριος,0,52,22,724,798
O,15,Δημόσια διοίκηση και άμυνα. Υποχρεωτική κοινωνική ασφάλιση,2016,Φεβρουάριος,0,17,1,1958,1976
P,16,Εκπαίδευση,2016,Φεβρουάριος,0,9,1,299,309
Q,17,Δραστηριότητες σχετικές με την ανθρώπινη υγεία και την κοινωνική μέριμνα,2016,Φεβρουάριος,0,0,1,280,281
R,18,"Τέχνες, διασκέδαση και ψυχαγωγία",2016,Φεβρουάριος,0,48,9,381,438
S,19,Άλλες δραστηριότητες παροχής υπηρεσιών,2016,Φεβρουάριος,0,18,31,366,415
T,20,Δραστηριότητες νοικοκυριών ως εργοδοτών,2016,Φεβρουάριος,0,0,0,27,27
U,21,Δραστηριότητες ετερόδικων οργανισμών και φορέων,2016,Φεβρουάριος,0,0,0,26,26
N/A,22,Μη δηλωμένη οικονομική δραστηριότητα,2016,Φεβρουάριος,0,11,87,1549,1647
LIM,23,Λιμενεργάτες,2016,Φεβρουάριος,0,0,0,13,13
Σύνολο,Σύνολο,Σύνολο,2016,Φεβρουάριος,49,4730,5168,18056,28003
A,1,"Γεωργία, δασοκομία και αλιεία",2016,Μάρτιος,0,0,0,114,114
B,2,Ορυχεία και λατομεία,2016,Μάρτιος,0,0,0,21,21
C,3,Μεταποίηση,2016,Μάρτιος,53,0,4,1179,1236
D,4,"Παροχή ηλεκτρικού ρεύματος, φυσικού αερίου, ατμού και κλιματισμού",2016,Μάρτιος,0,0,0,30,30
E,5,"Παροχή νερού, επεξεργασία λυμάτων, διαχείριση αποβλήτων και δραστηριότητες εξυγίανσης",2016,Μάρτιος,0,0,0,7,7
F,6,Κατασκευές,2016,Μάρτιος,0,1,19,1241,1261
G,7,Χονδρικό και λιανικό εμπόριο.  Επισκευή μηχανοκίνητων οχημάτων και μοτοσυκλετών,2016,Μάρτιος,0,220,43,3435,3698
H,8,Μεταφορά και αποθήκευση,2016,Μάρτιος,0,38,9,1172,1219
I,9,Δραστηριότητες υπηρεσιών παροχής καταλύματος και υπηρεσιών εστίασης,2016,Μάρτιος,0,3056,4429,3233,10718
J,10,Ενημέρωση και επικοινωνία,2016,Μάρτιος,0,0,0,280,280
K,11,Χρηματοπιστωτικές και ασφαλιστικές δραστηριότητες,2016,Μάρτιος,0,0,0,339,339
L,12,Διαχείριση ακίνητης περιουσίας,2016,Μάρτιος,0,9,23,151,183
M,13,"Επαγγελματικές, επιστημονικές και τεχνικές δραστηριότητες",2016,Μάρτιος,0,0,0,723,723
N,14,Διοικητικές και υποστηρικτικές δραστηριότητες,2016,Μάρτιος,0,51,19,654,724
O,15,Δημόσια διοίκηση και άμυνα. Υποχρεωτική κοινωνική ασφάλιση,2016,Μάρτιος,0,16,1,1743,1760
P,16,Εκπαίδευση,2016,Μάρτιος,0,10,1,278,289
Q,17,Δραστηριότητες σχετικές με την ανθρώπινη υγεία και την κοινωνική μέριμνα,2016,Μάρτιος,0,0,0,263,263
R,18,"Τέχνες, διασκέδαση και ψυχαγωγία",2016,Μάρτιος,0,45,10,376,431
S,19,Άλλες δραστηριότητες παροχής υπηρεσιών,2016,Μάρτιος,0,16,26,357,399
T,20,Δραστηριότητες νοικοκυριών ως εργοδοτών,2016,Μάρτιος,0,0,0,27,27
U,21,Δραστηριότητες ετερόδικων οργανισμών και φορέων,2016,Μάρτιος,0,0,0,23,23
N/A,22,Μη δηλωμένη οικονομική δραστηριότητα,2016,Μάρτιος,0,8,77,1500,1585
LIM,23,Λιμενεργάτες,2016,Μάρτιος,0,0,0,7,7
Σύνολο,Σύνολο,Σύνολο,2016,Μάρτιος,53,3470,4661,17153,25337
A,1,"Γεωργία, δασοκομία και αλιεία",2016,Απρίλιος,0,0,0,103,103
B,2,Ορυχεία και λατομεία,2016,Απρίλιος,0,0,0,20,20
C,3,Μεταποίηση,2016,Απρίλιος,10,0,3,1065,1078
D,4,"Παροχή ηλεκτρικού ρεύματος, φυσικού αερίου, ατμού και κλιματισμού",2016,Απρίλιος,0,0,0,28,28
E,5,"Παροχή νερού, επεξεργασία λυμάτων, διαχείριση αποβλήτων και δραστηριότητες εξυγίανσης",2016,Απρίλιος,0,0,0,9,9
F,6,Κατασκευές,2016,Απρίλιος,0,0,17,1191,1208
G,7,Χονδρικό και λιανικό εμπόριο.  Επισκευή μηχανοκίνητων οχημάτων και μοτοσυκλετών,2016,Απρίλιος,0,1,36,3287,3324
H,8,Μεταφορά και αποθήκευση,2016,Απρίλιος,0,2,6,897,905
I,9,Δραστηριότητες υπηρεσιών παροχής καταλύματος και υπηρεσιών εστίασης,2016,Απρίλιος,0,18,2859,2559,5436
J,10,Ενημέρωση και επικοινωνία,2016,Απρίλιος,0,0,0,275,275
K,11,Χρηματοπιστωτικές και ασφαλιστικές δραστηριότητες,2016,Απρίλιος,0,0,0,560,560
L,12,Διαχείριση ακίνητης περιουσίας,2016,Απρίλιος,0,0,11,128,139
M,13,"Επαγγελματικές, επιστημονικές και τεχνικές δραστηριότητες",2016,Απρίλιος,0,0,0,716,716
N,14,Διοικητικές και υποστηρικτικές δραστηριότητες,2016,Απρίλιος,0,0,12,558,570
O,15,Δημόσια διοίκηση και άμυνα. Υποχρεωτική κοινωνική ασφάλιση,2016,Απρίλιος,0,1,1,1625,1627
P,16,Εκπαίδευση,2016,Απρίλιος,0,0,0,294,294
Q,17,Δραστηριότητες σχετικές με την ανθρώπινη υγεία και την κοινωνική μέριμνα,2016,Απρίλιος,0,0,0,251,251
R,18,"Τέχνες, διασκέδαση και ψυχαγωγία",2016,Απρίλιος,0,1,9,352,362
S,19,Άλλες δραστηριότητες παροχής υπηρεσιών,2016,Απρίλιος,0,0,19,323,342
T,20,Δραστηριότητες νοικοκυριών ως εργοδοτών,2016,Απρίλιος,0,0,0,29,29
U,21,Δραστηριότητες ετερόδικων οργανισμών και φορέων,2016,Απρίλιος,0,0,0,21,21
N/A,22,Μη δηλωμένη οικονομική δραστηριότητα,2016,Απρίλιος,0,0,50,1379,1429
LIM,23,Λιμενεργάτες,2016,Απρίλιος,0,0,0,5,5
Σύνολο,Σύνολο,Σύνολο,2016,Απρίλιος,10,23,3023,15675,18731
A,1,"Γεωργία, δασοκομία και αλιεία",2016,Μάιος,0,0,0,102,102
B,2,Ορυχεία και λατομεία,2016,Μάιος,0,0,0,24,24
C,3,Μεταποίηση,2016,Μάιος,1,0,1,1012,1014
D,4,"Παροχή ηλεκτρικού ρεύματος, φυσικού αερίου, ατμού και κλιματισμού",2016,Μάιος,0,0,0,25,25
E,5,"Παροχή νερού, επεξεργασία λυμάτων, διαχείριση αποβλήτων και δραστηριότητες εξυγίανσης",2016,Μάιος,0,0,0,10,10
F,6,Κατασκευές,2016,Μάιος,0,0,14,1137,1151
G,7,Χονδρικό και λιανικό εμπόριο.  Επισκευή μηχανοκίνητων οχημάτων και μοτοσυκλετών,2016,Μάιος,0,0,20,3018,3038
H,8,Μεταφορά και αποθήκευση,2016,Μάιος,0,1,6,696,703
I,9,Δραστηριότητες υπηρεσιών παροχής καταλύματος και υπηρεσιών εστίασης,2016,Μάιος,0,7,1165,1870,3042
J,10,Ενημέρωση και επικοινωνία,2016,Μάιος,0,0,0,268,268
K,11,Χρηματοπιστωτικές και ασφαλιστικές δραστηριότητες,2016,Μάιος,0,0,0,656,656
L,12,Διαχείριση ακίνητης περιουσίας,2016,Μάιος,0,0,2,99,101
M,13,"Επαγγελματικές, επιστημονικές και τεχνικές δραστηριότητες",2016,Μάιος,0,0,0,730,730
N,14,Διοικητικές και υποστηρικτικές δραστηριότητες,2016,Μάιος,0,0,12,466,478
O,15,Δημόσια διοίκηση και άμυνα. Υποχρεωτική κοινωνική ασφάλιση,2016,Μάιος,0,1,0,721,722
P,16,Εκπαίδευση,2016,Μάιος,0,0,0,399,399
Q,17,Δραστηριότητες σχετικές με την ανθρώπινη υγεία και την κοινωνική μέριμνα,2016,Μάιος,0,0,0,239,239
R,18,"Τέχνες, διασκέδαση και ψυχαγωγία",2016,Μάιος,0,0,7,289,296
S,19,Άλλες δραστηριότητες παροχής υπηρεσιών,2016,Μάιος,0,0,13,284,297
T,20,Δραστηριότητες νοικοκυριών ως εργοδοτών,2016,Μάιος,0,0,0,29,29
U,21,Δραστηριότητες ετερόδικων οργανισμών και φορέων,2016,Μάιος,0,0,0,19,19
N/A,22,Μη δηλωμένη οικονομική δραστηριότητα,2016,Μάιος,0,0,20,1359,1379
LIM,23,Λιμενεργάτες,2016,Μάιος,0,0,0,8,8
Σύνολο,Σύνολο,Σύνολο,2016,Μάιος,1,9,1260,13460,14730
A,1,"Γεωργία, δασοκομία και αλιεία",2016,Ιούνιος,0,0,0,112,112
B,2,Ορυχεία και λατομεία,2016,Ιούνιος,0,0,0,23,23
C,3,Μεταποίηση,2016,Ιούνιος,1,0,0,972,973
D,4,"Παροχή ηλεκτρικού ρεύματος, φυσικού αερίου, ατμού και κλιματισμού",2016,Ιούνιος,0,0,0,17,17
E,5,"Παροχή νερού, επεξεργασία λυμάτων, διαχείριση αποβλήτων και δραστηριότητες εξυγίανσης",2016,Ιούνιος,0,0,0,7,7
F,6,Κατασκευές,2016,Ιούνιος,0,0,8,1042,1050
G,7,Χονδρικό και λιανικό εμπόριο.  Επισκευή μηχανοκίνητων οχημάτων και μοτοσυκλετών,2016,Ιούνιος,0,0,9,2688,2697
H,8,Μεταφορά και αποθήκευση,2016,Ιούνιος,0,0,1,413,414
I,9,Δραστηριότητες υπηρεσιών παροχής καταλύματος και υπηρεσιών εστίασης,2016,Ιούνιος,0,2,307,1245,1554
J,10,Ενημέρωση και επικοινωνία,2016,Ιούνιος,0,0,0,320,320
K,11,Χρηματοπιστωτικές και ασφαλιστικές δραστηριότητες,2016,Ιούνιος,0,0,0,879,879
L,12,Διαχείριση ακίνητης περιουσίας,2016,Ιούνιος,0,0,1,78,79
M,13,"Επαγγελματικές, επιστημονικές και τεχνικές δραστηριότητες",2016,Ιούνιος,0,0,0,718,718
N,14,Διοικητικές και υποστηρικτικές δραστηριότητες,2016,Ιούνιος,0,0,3,327,330
O,15,Δημόσια διοίκηση και άμυνα. Υποχρεωτική κοινωνική ασφάλιση,2016,Ιούνιος,0,0,0,1175,1175
P,16,Εκπαίδευση,2016,Ιούνιος,0,0,0,1320,1320
Q,17,Δραστηριότητες σχετικές με την ανθρώπινη υγεία και την κοινωνική μέριμνα,2016,Ιούνιος,0,0,0,246,246
R,18,"Τέχνες, διασκέδαση και ψυχαγωγία",2016,Ιούνιος,0,0,3,241,244
S,19,Άλλες δραστηριότητες παροχής υπηρεσιών,2016,Ιούνιος,0,0,3,287,290
T,20,Δραστηριότητες νοικοκυριών ως εργοδοτών,2016,Ιούνιος,0,0,0,31,31
U,21,Δραστηριότητες ετερόδικων οργανισμών και φορέων,2016,Ιούνιος,0,0,0,15,15
N/A,22,Μη δηλωμένη οικονομική δραστηριότητα,2016,Ιούνιος,0,0,3,1462,1465
LIM,23,Λιμενεργάτες,2016,Ιούνιος,0,0,0,3,3
Σύνολο,Σύνολο,Σύνολο,2016,Ιούνιος,1,2,338,13621,13962
A,1,"Γεωργία, δασοκομία και αλιεία",2016,Ιούλιος,0,0,0,105,105
B,2,Ορυχεία και λατομεία,2016,Ιούλιος,0,0,0,26,26
C,3,Μεταποίηση,2016,Ιούλιος,1,0,0,942,943
D,4,"Παροχή ηλεκτρικού ρεύματος, φυσικού αερίου, ατμού και κλιματισμού",2016,Ιούλιος,0,0,0,15,15
E,5,"Παροχή νερού, επεξεργασία λυμάτων, διαχείριση αποβλήτων και δραστηριότητες εξυγίανσης",2016,Ιούλιος,0,0,0,8,8
F,6,Κατασκευές,2016,Ιούλιος,0,0,6,955,961
G,7,Χονδρικό και λιανικό εμπόριο.  Επισκευή μηχανοκίνητων οχημάτων και μοτοσυκλετών,2016,Ιούλιος,0,0,8,2728,2736
H,8,Μεταφορά και αποθήκευση,2016,Ιούλιος,0,0,0,370,370
I,9,Δραστηριότητες υπηρεσιών παροχής καταλύματος και υπηρεσιών εστίασης,2016,Ιούλιος,0,1,242,1182,1425
J,10,Ενημέρωση και επικοινωνία,2016,Ιούλιος,0,0,0,340,340
K,11,Χρηματοπιστωτικές και ασφαλιστικές δραστηριότητες,2016,Ιούλιος,0,0,0,894,894
L,12,Διαχείριση ακίνητης περιουσίας,2016,Ιούλιος,0,0,0,71,71
M,13,"Επαγγελματικές, επιστημονικές και τεχνικές δραστηριότητες",2016,Ιούλιος,0,0,0,716,716
N,14,Διοικητικές και υποστηρικτικές δραστηριότητες,2016,Ιούλιος,0,0,3,309,312
O,15,Δημόσια διοίκηση και άμυνα. Υποχρεωτική κοινωνική ασφάλιση,2016,Ιούλιος,0,0,0,1555,1555
P,16,Εκπαίδευση,2016,Ιούλιος,0,0,0,2276,2276
Q,17,Δραστηριότητες σχετικές με την ανθρώπινη υγεία και την κοινωνική μέριμνα,2016,Ιούλιος,0,0,0,254,254
R,18,"Τέχνες, διασκέδαση και ψυχαγωγία",2016,Ιούλιος,0,0,3,230,233
S,19,Άλλες δραστηριότητες παροχής υπηρεσιών,2016,Ιούλιος,0,0,1,369,370
T,20,Δραστηριότητες νοικοκυριών ως εργοδοτών,2016,Ιούλιος,0,0,0,28,28
U,21,Δραστηριότητες ετερόδικων οργανισμών και φορέων,2016,Ιούλιος,0,0,0,16,16
N/A,22,Μη δηλωμένη οικονομική δραστηριότητα,2016,Ιούλιος,0,0,3,1421,1424
LIM,23,Λιμενεργάτες,2016,Ιούλιος,0,0,0,4,4
Σύνολο,Σύνολο,Σύνολο,2016,Ιούλιος,1,1,266,14814,15082
A,1,"Γεωργία, δασοκομία και αλιεία",2016,Αύγουστος,0,0,0,96,96
B,2,Ορυχεία και λατομεία,2016,Αύγουστος,0,0,0,32,32
C,3,Μεταποίηση,2016,Αύγουστος,1,0,0,919,920
D,4,"Παροχή ηλεκτρικού ρεύματος, φυσικού αερίου, ατμού και κλιματισμού",2016,Αύγουστος,0,0,0,11,11
E,5,"Παροχή νερού, επεξεργασία λυμάτων, διαχείριση αποβλήτων και δραστηριότητες εξυγίανσης",2016,Αύγουστος,0,0,0,8,8
F,6,Κατασκευές,2016,Αύγουστος,0,0,6,893,899
G,7,Χονδρικό και λιανικό εμπόριο.  Επισκευή μηχανοκίνητων οχημάτων και μοτοσυκλετών,2016,Αύγουστος,0,0,6,2746,2752
H,8,Μεταφορά και αποθήκευση,2016,Αύγουστος,0,0,0,362,362
I,9,Δραστηριότητες υπηρεσιών παροχής καταλύματος και υπηρεσιών εστίασης,2016,Αύγουστος,0,1,234,1186,1421
J,10,Ενημέρωση και επικοινωνία,2016,Αύγουστος,0,0,0,354,354
K,11,Χρηματοπιστωτικές και ασφαλιστικές δραστηριότητες,2016,Αύγουστος,0,0,0,932,932
L,12,Διαχείριση ακίνητης περιουσίας,2016,Αύγουστος,0,0,1,76,77
M,13,"Επαγγελματικές, επιστημονικές και τεχνικές δραστηριότητες",2016,Αύγουστος,0,0,0,735,735
N,14,Διοικητικές και υποστηρικτικές δραστηριότητες,2016,Αύγουστος,0,0,5,310,315
O,15,Δημόσια διοίκηση και άμυνα. Υποχρεωτική κοινωνική ασφάλιση,2016,Αύγουστος,0,0,0,1639,1639
P,16,Εκπαίδευση,2016,Αύγουστος,0,0,0,2424,2424
Q,17,Δραστηριότητες σχετικές με την ανθρώπινη υγεία και την κοινωνική μέριμνα,2016,Αύγουστος,0,0,0,271,271
R,18,"Τέχνες, διασκέδαση και ψυχαγωγία",2016,Αύγουστος,0,0,2,243,245
S,19,Άλλες δραστηριότητες παροχής υπηρεσιών,2016,Αύγουστος,0,0,1,404,405
T,20,Δραστηριότητες νοικοκυριών ως εργοδοτών,2016,Αύγουστος,0,0,0,27,27
U,21,Δραστηριότητες ετερόδικων οργανισμών και φορέων,2016,Αύγουστος,0,0,0,16,16
N/A,22,Μη δηλωμένη οικονομική δραστηριότητα,2016,Αύγουστος,0,0,2,1471,1473
LIM,23,Λιμενεργάτες,2016,Αύγουστος,0,0,0,5,5
Σύνολο,Σύνολο,Σύνολο,2016,Αύγουστος,1,1,257,15160,15419
A,1,"Γεωργία, δασοκομία και αλιεία",2016,Σεπτέμβριος,0,0,0,103,103
B,2,Ορυχεία και λατομεία,2016,Σεπτέμβριος,0,0,0,32,32
C,3,Μεταποίηση,2016,Σεπτέμβριος,2,0,0,939,941
D,4,"Παροχή ηλεκτρικού ρεύματος, φυσικού αερίου, ατμού και κλιματισμού",2016,Σεπτέμβριος,0,0,0,10,10
E,5,"Παροχή νερού, επεξεργασία λυμάτων, διαχείριση αποβλήτων και δραστηριότητες εξυγίανσης",2016,Σεπτέμβριος,0,0,0,7,7
F,6,Κατασκευές,2016,Σεπτέμβριος,0,0,6,867,873
G,7,Χονδρικό και λιανικό εμπόριο.  Επισκευή μηχανοκίνητων οχημάτων και μοτοσυκλετών,2016,Σεπτέμβριος,0,0,6,2770,2776
H,8,Μεταφορά και αποθήκευση,2016,Σεπτέμβριος,0,0,0,360,360
I,9,Δραστηριότητες υπηρεσιών παροχής καταλύματος και υπηρεσιών εστίασης,2016,Σεπτέμβριος,0,1,208,1234,1443
J,10,Ενημέρωση και επικοινωνία,2016,Σεπτέμβριος,0,0,0,304,304
K,11,Χρηματοπιστωτικές και ασφαλιστικές δραστηριότητες,2016,Σεπτέμβριος,0,0,0,943,943
L,12,Διαχείριση ακίνητης περιουσίας,2016,Σεπτέμβριος,0,0,1,83,84
M,13,"Επαγγελματικές, επιστημονικές και τεχνικές δραστηριότητες",2016,Σεπτέμβριος,0,0,0,756,756
N,14,Διοικητικές και υποστηρικτικές δραστηριότητες,2016,Σεπτέμβριος,0,0,4,303,307
O,15,Δημόσια διοίκηση και άμυνα. Υποχρεωτική κοινωνική ασφάλιση,2016,Σεπτέμβριος,0,0,0,1240,1240
P,16,Εκπαίδευση,2016,Σεπτέμβριος,0,0,0,1322,1322
Q,17,Δραστηριότητες σχετικές με την ανθρώπινη υγεία και την κοινωνική μέριμνα,2016,Σεπτέμβριος,0,0,0,262,262
R,18,"Τέχνες, διασκέδαση και ψυχαγωγία",2016,Σεπτέμβριος,0,0,2,200,202
S,19,Άλλες δραστηριότητες παροχής υπηρεσιών,2016,Σεπτέμβριος,0,0,1,332,333
T,20,Δραστηριότητες νοικοκυριών ως εργοδοτών,2016,Σεπτέμβριος,0,0,0,29,29
U,21,Δραστηριότητες ετερόδικων οργανισμών και φορέων,2016,Σεπτέμβριος,0,0,0,18,18
N/A,22,Μη δηλωμένη οικονομική δραστηριότητα,2016,Σεπτέμβριος,0,0,2,1418,1420
LIM,23,Λιμενεργάτες,2016,Σεπτέμβριος,0,0,0,5,5
Σύνολο,Σύνολο,Σύνολο,2016,Σεπτέμβριος,2,1,230,13537,13770
A,1,"Γεωργία, δασοκομία και αλιεία",2016,Οκτώβριος,0,0,0,105,105
B,2,Ορυχεία και λατομεία,2016,Οκτώβριος,0,0,0,30,30
C,3,Μεταποίηση,2016,Οκτώβριος,2,0,0,987,989
D,4,"Παροχή ηλεκτρικού ρεύματος, φυσικού αερίου, ατμού και κλιματισμού",2016,Οκτώβριος,0,0,0,8,8
E,5,"Παροχή νερού, επεξεργασία λυμάτων, διαχείριση αποβλήτων και δραστηριότητες εξυγίανσης",2016,Οκτώβριος,0,0,0,6,6
F,6,Κατασκευές,2016,Οκτώβριος,0,0,6,819,825
G,7,Χονδρικό και λιανικό εμπόριο.  Επισκευή μηχανοκίνητων οχημάτων και μοτοσυκλετών,2016,Οκτώβριος,0,0,5,2824,2829
H,8,Μεταφορά και αποθήκευση,2016,Οκτώβριος,0,0,0,354,354
I,9,Δραστηριότητες υπηρεσιών παροχής καταλύματος και υπηρεσιών εστίασης,2016,Οκτώβριος,0,1,452,1370,1823
J,10,Ενημέρωση και επικοινωνία,2016,Οκτώβριος,0,0,0,285,285
K,11,Χρηματοπιστωτικές και ασφαλιστικές δραστηριότητες,2016,Οκτώβριος,0,0,0,966,966
L,12,Διαχείριση ακίνητης περιουσίας,2016,Οκτώβριος,0,0,2,84,86
M,13,"Επαγγελματικές, επιστημονικές και τεχνικές δραστηριότητες",2016,Οκτώβριος,0,0,0,770,770
N,14,Διοικητικές και υποστηρικτικές δραστηριότητες,2016,Οκτώβριος,0,0,7,305,312
O,15,Δημόσια διοίκηση και άμυνα. Υποχρεωτική κοινωνική ασφάλιση,2016,Οκτώβριος,0,0,0,459,459
P,16,Εκπαίδευση,2016,Οκτώβριος,0,0,0,478,478
Q,17,Δραστηριότητες σχετικές με την ανθρώπινη υγεία και την κοινωνική μέριμνα,2016,Οκτώβριος,0,0,0,243,243
R,18,"Τέχνες, διασκέδαση και ψυχαγωγία",2016,Οκτώβριος,0,0,1,199,200
S,19,Άλλες δραστηριότητες παροχής υπηρεσιών,2016,Οκτώβριος,0,0,9,255,264
T,20,Δραστηριότητες νοικοκυριών ως εργοδοτών,2016,Οκτώβριος,0,0,0,33,33
U,21,Δραστηριότητες ετερόδικων οργανισμών και φορέων,2016,Οκτώβριος,0,0,0,17,17
N/A,22,Μη δηλωμένη οικονομική δραστηριότητα,2016,Οκτώβριος,0,0,1,1254,1255
LIM,23,Λιμενεργάτες,2016,Οκτώβριος,0,0,0,4,4
Σύνολο,Σύνολο,Σύνολο,2016,Οκτώβριος,2,1,483,11855,12341
A,1,"Γεωργία, δασοκομία και αλιεία",2016,Νοέμβριος,0,0,1,86,87
B,2,Ορυχεία και λατομεία,2016,Νοέμβριος,0,0,0,27,27
C,3,Μεταποίηση,2016,Νοέμβριος,24,0,2,1006,1032
D,4,"Παροχή ηλεκτρικού ρεύματος, φυσικού αερίου, ατμού και κλιματισμού",2016,Νοέμβριος,0,0,0,7,7
E,5,"Παροχή νερού, επεξεργασία λυμάτων, διαχείριση αποβλήτων και δραστηριότητες εξυγίανσης",2016,Νοέμβριος,0,0,0,2,2
F,6,Κατασκευές,2016,Νοέμβριος,0,0,5,765,770
G,7,Χονδρικό και λιανικό εμπόριο.  Επισκευή μηχανοκίνητων οχημάτων και μοτοσυκλετών,2016,Νοέμβριος,0,165,31,3302,3498
H,8,Μεταφορά και αποθήκευση,2016,Νοέμβριος,0,26,4,787,817
I,9,Δραστηριότητες υπηρεσιών παροχής καταλύματος και υπηρεσιών εστίασης,2016,Νοέμβριος,0,1443,4325,2763,8531
J,10,Ενημέρωση και επικοινωνία,2016,Νοέμβριος,0,0,0,286,286
K,11,Χρηματοπιστωτικές και ασφαλιστικές δραστηριότητες,2016,Νοέμβριος,0,0,1,951,952
L,12,Διαχείριση ακίνητης περιουσίας,2016,Νοέμβριος,0,0,9,287,296
M,13,"Επαγγελματικές, επιστημονικές και τεχνικές δραστηριότητες",2016,Νοέμβριος,0,1,0,759,760
N,14,Διοικητικές και υποστηρικτικές δραστηριότητες,2016,Νοέμβριος,0,50,41,552,643
O,15,Δημόσια διοίκηση και άμυνα. Υποχρεωτική κοινωνική ασφάλιση,2016,Νοέμβριος,0,7,0,693,700
P,16,Εκπαίδευση,2016,Νοέμβριος,0,11,0,308,319
Q,17,Δραστηριότητες σχετικές με την ανθρώπινη υγεία και την κοινωνική μέριμνα,2016,Νοέμβριος,0,0,1,257,258
R,18,"Τέχνες, διασκέδαση και ψυχαγωγία",2016,Νοέμβριος,0,40,11,364,415
S,19,Άλλες δραστηριότητες παροχής υπηρεσιών,2016,Νοέμβριος,0,6,25,329,360
T,20,Δραστηριότητες νοικοκυριών ως εργοδοτών,2016,Νοέμβριος,0,0,0,32,32
U,21,Δραστηριότητες ετερόδικων οργανισμών και φορέων,2016,Νοέμβριος,0,0,0,19,19
N/A,22,Μη δηλωμένη οικονομική δραστηριότητα,2016,Νοέμβριος,0,1,29,1149,1179
LIM,23,Λιμενεργάτες,2016,Νοέμβριος,0,0,0,2,2
Σύνολο,Σύνολο,Σύνολο,2016,Νοέμβριος,24,1750,4485,14733,20992
A,1,"Γεωργία, δασοκομία και αλιεία",2016,Δεκέμβριος,0,0,1,92,93
B,2,Ορυχεία και λατομεία,2016,Δεκέμβριος,0,0,0,25,25
C,3,Μεταποίηση,2016,Δεκέμβριος,38,0,3,1017,1058
D,4,"Παροχή ηλεκτρικού ρεύματος, φυσικού αερίου, ατμού και κλιματισμού",2016,Δεκέμβριος,0,0,0,7,7
E,5,"Παροχή νερού, επεξεργασία λυμάτων, διαχείριση αποβλήτων και δραστηριότητες εξυγίανσης",2016,Δεκέμβριος,0,0,0,2,2
F,6,Κατασκευές,2016,Δεκέμβριος,0,1,6,732,739
G,7,Χονδρικό και λιανικό εμπόριο.  Επισκευή μηχανοκίνητων οχημάτων και μοτοσυκλετών,2016,Δεκέμβριος,0,225,48,3321,3594
H,8,Μεταφορά και αποθήκευση,2016,Δεκέμβριος,0,33,6,960,999
I,9,Δραστηριότητες υπηρεσιών παροχής καταλύματος και υπηρεσιών εστίασης,2016,Δεκέμβριος,0,2878,5503,3153,11534
J,10,Ενημέρωση και επικοινωνία,2016,Δεκέμβριος,0,0,0,271,271
K,11,Χρηματοπιστωτικές και ασφαλιστικές δραστηριότητες,2016,Δεκέμβριος,0,0,1,923,924
L,12,Διαχείριση ακίνητης περιουσίας,2016,Δεκέμβριος,0,3,13,300,316
M,13,"Επαγγελματικές, επιστημονικές και τεχνικές δραστηριότητες",2016,Δεκέμβριος,0,2,0,723,725
N,14,Διοικητικές και υποστηρικτικές δραστηριότητες,2016,Δεκέμβριος,0,48,68,634,750
O,15,Δημόσια διοίκηση και άμυνα. Υποχρεωτική κοινωνική ασφάλιση,2016,Δεκέμβριος,0,10,0,1699,1709
P,16,Εκπαίδευση,2016,Δεκέμβριος,0,12,1,281,294
Q,17,Δραστηριότητες σχετικές με την ανθρώπινη υγεία και την κοινωνική μέριμνα,2016,Δεκέμβριος,0,0,1,263,264
R,18,"Τέχνες, διασκέδαση και ψυχαγωγία",2016,Δεκέμβριος,0,44,12,382,438
S,19,Άλλες δραστηριότητες παροχής υπηρεσιών,2016,Δεκέμβριος,0,9,31,386,426
T,20,Δραστηριότητες νοικοκυριών ως εργοδοτών,2016,Δεκέμβριος,0,0,0,30,30
U,21,Δραστηριότητες ετερόδικων οργανισμών και φορέων,2016,Δεκέμβριος,0,0,0,14,14
N/A,22,Μη δηλωμένη οικονομική δραστηριότητα,2016,Δεκέμβριος,0,3,31,1108,1142
LIM,23,Λιμενεργάτες,2016,Δεκέμβριος,0,0,0,3,3
Σύνολο,Σύνολο,Σύνολο,2016,Δεκέμβριος,38,3268,5725,16326,25357
A,1,"Γεωργία, δασοκομία και αλιεία",2017,Ιανουάριος,0,0,1,100,101
B,2,Ορυχεία και λατομεία,2017,Ιανουάριος,0,0,0,27,27
C,3,Μεταποίηση,2017,Ιανουάριος,59,0,4,1085,1148
D,4,"Παροχή ηλεκτρικού ρεύματος, φυσικού αερίου, ατμού και κλιματισμού",2017,Ιανουάριος,0,0,0,6,6
E,5,"Παροχή νερού, επεξεργασία λυμάτων, διαχείριση αποβλήτων και δραστηριότητες εξυγίανσης",2017,Ιανουάριος,0,0,0,7,7
F,6,Κατασκευές,2017,Ιανουάριος,0,1,8,759,768
G,7,Χονδρικό και λιανικό εμπόριο.  Επισκευή μηχανοκίνητων οχημάτων και μοτοσυκλετών,2017,Ιανουάριος,0,227,51,3488,3766
H,8,Μεταφορά και αποθήκευση,2017,Ιανουάριος,0,34,7,992,1033
I,9,Δραστηριότητες υπηρεσιών παροχής καταλύματος και υπηρεσιών εστίασης,2017,Ιανουάριος,0,3528,5581,3343,12452
J,10,Ενημέρωση και επικοινωνία,2017,Ιανουάριος,0,0,0,275,275
K,11,Χρηματοπιστωτικές και ασφαλιστικές δραστηριότητες,2017,Ιανουάριος,0,0,0,942,942
L,12,Διαχείριση ακίνητης περιουσίας,2017,Ιανουάριος,0,4,13,293,310
M,13,"Επαγγελματικές, επιστημονικές και τεχνικές δραστηριότητες",2017,Ιανουάριος,0,2,0,761,763
N,14,Διοικητικές και υποστηρικτικές δραστηριότητες,2017,Ιανουάριος,0,50,70,649,769
O,15,Δημόσια διοίκηση και άμυνα. Υποχρεωτική κοινωνική ασφάλιση,2017,Ιανουάριος,0,11,0,2044,2055
P,16,Εκπαίδευση,2017,Ιανουάριος,0,11,1,287,299
Q,17,Δραστηριότητες σχετικές με την ανθρώπινη υγεία και την κοινωνική μέριμνα,2017,Ιανουάριος,0,0,1,270,271
R,18,"Τέχνες, διασκέδαση και ψυχαγωγία",2017,Ιανουάριος,0,43,13,400,456
S,19,Άλλες δραστηριότητες παροχής υπηρεσιών,2017,Ιανουάριος,0,15,33,412,460
T,20,Δραστηριότητες νοικοκυριών ως εργοδοτών,2017,Ιανουάριος,0,0,0,36,36
U,21,Δραστηριότητες ετερόδικων οργανισμών και φορέων,2017,Ιανουάριος,0,0,0,16,16
N/A,22,Μη δηλωμένη οικονομική δραστηριότητα,2017,Ιανουάριος,0,5,47,1199,1251
LIM,23,Λιμενεργάτες,2017,Ιανουάριος,0,0,0,0,0
Σύνολο,Σύνολο,Σύνολο,2017,Ιανουάριος,59,3931,5830,17391,27211
A,1,"Γεωργία, δασοκομία και αλιεία",2017,Φεβρουάριος,0,0,1,96,97
B,2,Ορυχεία και λατομεία,2017,Φεβρουάριος,0,0,0,20,20
C,3,Μεταποίηση,2017,Φεβρουάριος,47,0,4,1041,1092
D,4,"Παροχή ηλεκτρικού ρεύματος, φυσικού αερίου, ατμού και κλιματισμού",2017,Φεβρουάριος,0,0,0,5,5
E,5,"Παροχή νερού, επεξεργασία λυμάτων, διαχείριση αποβλήτων και δραστηριότητες εξυγίανσης",2017,Φεβρουάριος,0,0,0,7,7
F,6,Κατασκευές,2017,Φεβρουάριος,0,1,8,714,723
G,7,Χονδρικό και λιανικό εμπόριο.  Επισκευή μηχανοκίνητων οχημάτων και μοτοσυκλετών,2017,Φεβρουάριος,0,223,51,3473,3747
H,8,Μεταφορά και αποθήκευση,2017,Φεβρουάριος,0,32,7,983,1022
I,9,Δραστηριότητες υπηρεσιών παροχής καταλύματος και υπηρεσιών εστίασης,2017,Φεβρουάριος,0,3505,5365,3315,12185
J,10,Ενημέρωση και επικοινωνία,2017,Φεβρουάριος,0,0,0,269,269
K,11,Χρηματοπιστωτικές και ασφαλιστικές δραστηριότητες,2017,Φεβρουάριος,0,0,0,898,898
L,12,Διαχείριση ακίνητης περιουσίας,2017,Φεβρουάριος,0,4,11,278,293
M,13,"Επαγγελματικές, επιστημονικές και τεχνικές δραστηριότητες",2017,Φεβρουάριος,0,1,0,724,725
N,14,Διοικητικές και υποστηρικτικές δραστηριότητες,2017,Φεβρουάριος,0,51,67,618,736
O,15,Δημόσια διοίκηση και άμυνα. Υποχρεωτική κοινωνική ασφάλιση,2017,Φεβρουάριος,0,11,1,1890,1902
P,16,Εκπαίδευση,2017,Φεβρουάριος,0,11,1,247,259
Q,17,Δραστηριότητες σχετικές με την ανθρώπινη υγεία και την κοινωνική μέριμνα,2017,Φεβρουάριος,0,0,1,279,280
R,18,"Τέχνες, διασκέδαση και ψυχαγωγία",2017,Φεβρουάριος,0,44,12,370,426
S,19,Άλλες δραστηριότητες παροχής υπηρεσιών,2017,Φεβρουάριος,0,21,29,401,451
T,20,Δραστηριότητες νοικοκυριών ως εργοδοτών,2017,Φεβρουάριος,0,0,0,36,36
U,21,Δραστηριότητες ετερόδικων οργανισμών και φορέων,2017,Φεβρουάριος,0,0,0,14,14
N/A,22,Μη δηλωμένη οικονομική δραστηριότητα,2017,Φεβρουάριος,0,4,49,1191,1244
LIM,23,Λιμενεργάτες,2017,Φεβρουάριος,0,0,0,1,1
Σύνολο,Σύνολο,Σύνολο,2017,Φεβρουάριος,47,3908,5607,16870,26432
A,1,"Γεωργία, δασοκομία και αλιεία",2017,Μάρτιος,0,0,1,98,99
B,2,Ορυχεία και λατομεία,2017,Μάρτιος,0,0,0,20,20
C,3,Μεταποίηση,2017,Μάρτιος,26,0,2,1049,1077
D,4,"Παροχή ηλεκτρικού ρεύματος, φυσικού αερίου, ατμού και κλιματισμού",2017,Μάρτιος,0,0,0,5,5
E,5,"Παροχή νερού, επεξεργασία λυμάτων, διαχείριση αποβλήτων και δραστηριότητες εξυγίανσης",2017,Μάρτιος,0,0,0,7,7
F,6,Κατασκευές,2017,Μάρτιος,0,1,7,700,708
G,7,Χονδρικό και λιανικό εμπόριο.  Επισκευή μηχανοκίνητων οχημάτων και μοτοσυκλετών,2017,Μάρτιος,0,214,43,3515,3772
H,8,Μεταφορά και αποθήκευση,2017,Μάρτιος,0,31,6,924,961
I,9,Δραστηριότητες υπηρεσιών παροχής καταλύματος και υπηρεσιών εστίασης,2017,Μάρτιος,0,2486,4823,3126,10435
J,10,Ενημέρωση και επικοινωνία,2017,Μάρτιος,0,0,0,276,276
K,11,Χρηματοπιστωτικές και ασφαλιστικές δραστηριότητες,2017,Μάρτιος,0,0,0,873,873
L,12,Διαχείριση ακίνητης περιουσίας,2017,Μάρτιος,0,0,10,273,283
M,13,"Επαγγελματικές, επιστημονικές και τεχνικές δραστηριότητες",2017,Μάρτιος,0,1,0,745,746
N,14,Διοικητικές και υποστηρικτικές δραστηριότητες,2017,Μάρτιος,0,50,34,602,686
O,15,Δημόσια διοίκηση και άμυνα. Υποχρεωτική κοινωνική ασφάλιση,2017,Μάρτιος,0,11,1,1757,1769
P,16,Εκπαίδευση,2017,Μάρτιος,0,11,1,244,256
Q,17,Δραστηριότητες σχετικές με την ανθρώπινη υγεία και την κοινωνική μέριμνα,2017,Μάρτιος,0,0,1,285,286
R,18,"Τέχνες, διασκέδαση και ψυχαγωγία",2017,Μάρτιος,0,44,13,386,443
S,19,Άλλες δραστηριότητες παροχής υπηρεσιών,2017,Μάρτιος,0,13,27,394,434
T,20,Δραστηριότητες νοικοκυριών ως εργοδοτών,2017,Μάρτιος,0,0,0,39,39
U,21,Δραστηριότητες ετερόδικων οργανισμών και φορέων,2017,Μάρτιος,0,0,0,14,14
N/A,22,Μη δηλωμένη οικονομική δραστηριότητα,2017,Μάρτιος,0,2,47,1198,1247
LIM,23,Λιμενεργάτες,2017,Μάρτιος,0,0,0,4,4
Σύνολο,Σύνολο,Σύνολο,2017,Μάρτιος,26,2864,5016,16534,24440
A,1,"Γεωργία, δασοκομία και αλιεία",2017,Απρίλιος,0,0,1,94,95
B,2,Ορυχεία και λατομεία,2017,Απρίλιος,0,0,0,17,17
C,3,Μεταποίηση,2017,Απρίλιος,7,0,2,994,1003
D,4,"Παροχή ηλεκτρικού ρεύματος, φυσικού αερίου, ατμού και κλιματισμού",2017,Απρίλιος,0,0,0,6,6
E,5,"Παροχή νερού, επεξεργασία λυμάτων, διαχείριση αποβλήτων και δραστηριότητες εξυγίανσης",2017,Απρίλιος,0,0,0,8,8
F,6,Κατασκευές,2017,Απρίλιος,0,0,7,667,674
G,7,Χονδρικό και λιανικό εμπόριο.  Επισκευή μηχανοκίνητων οχημάτων και μοτοσυκλετών,2017,Απρίλιος,0,46,27,3196,3269
H,8,Μεταφορά και αποθήκευση,2017,Απρίλιος,0,1,4,754,759
I,9,Δραστηριότητες υπηρεσιών παροχής καταλύματος και υπηρεσιών εστίασης,2017,Απρίλιος,0,232,3015,2458,5705
J,10,Ενημέρωση και επικοινωνία,2017,Απρίλιος,0,0,0,276,276
K,11,Χρηματοπιστωτικές και ασφαλιστικές δραστηριότητες,2017,Απρίλιος,0,0,0,789,789
L,12,Διαχείριση ακίνητης περιουσίας,2017,Απρίλιος,0,0,9,244,253
M,13,"Επαγγελματικές, επιστημονικές και τεχνικές δραστηριότητες",2017,Απρίλιος,0,0,0,712,712
N,14,Διοικητικές και υποστηρικτικές δραστηριότητες,2017,Απρίλιος,0,12,19,499,530
O,15,Δημόσια διοίκηση και άμυνα. Υποχρεωτική κοινωνική ασφάλιση,2017,Απρίλιος,0,1,1,1547,1549
P,16,Εκπαίδευση,2017,Απρίλιος,0,1,0,268,269
Q,17,Δραστηριότητες σχετικές με την ανθρώπινη υγεία και την κοινωνική μέριμνα,2017,Απρίλιος,0,0,0,277,277
R,18,"Τέχνες, διασκέδαση και ψυχαγωγία",2017,Απρίλιος,0,10,10,358,378
S,19,Άλλες δραστηριότητες παροχής υπηρεσιών,2017,Απρίλιος,0,1,17,337,355
T,20,Δραστηριότητες νοικοκυριών ως εργοδοτών,2017,Απρίλιος,0,0,0,37,37
U,21,Δραστηριότητες ετερόδικων οργανισμών και φορέων,2017,Απρίλιος,0,0,0,13,13
N/A,22,Μη δηλωμένη οικονομική δραστηριότητα,2017,Απρίλιος,0,0,25,1086,1111
LIM,23,Λιμενεργάτες,2017,Απρίλιος,0,0,0,2,2
Σύνολο,Σύνολο,Σύνολο,2017,Απρίλιος,7,304,3137,14639,18087
A,1,"Γεωργία, δασοκομία και αλιεία",2017,Μάιος,0,0,1,110,111
B,2,Ορυχεία και λατομεία,2017,Μάιος,0,0,0,17,17
C,3,Μεταποίηση,2017,Μάιος,0,0,1,944,945
D,4,"Παροχή ηλεκτρικού ρεύματος, φυσικού αερίου, ατμού και κλιματισμού",2017,Μάιος,0,0,0,7,7
E,5,"Παροχή νερού, επεξεργασία λυμάτων, διαχείριση αποβλήτων και δραστηριότητες εξυγίανσης",2017,Μάιος,0,0,0,7,7
F,6,Κατασκευές,2017,Μάιος,0,0,5,660,665
G,7,Χονδρικό και λιανικό εμπόριο.  Επισκευή μηχανοκίνητων οχημάτων και μοτοσυκλετών,2017,Μάιος,0,0,16,2873,2889
H,8,Μεταφορά και αποθήκευση,2017,Μάιος,0,0,1,611,612
I,9,Δραστηριότητες υπηρεσιών παροχής καταλύματος και υπηρεσιών εστίασης,2017,Μάιος,0,2,1073,1764,2839
J,10,Ενημέρωση και επικοινωνία,2017,Μάιος,0,0,0,283,283
K,11,Χρηματοπιστωτικές και ασφαλιστικές δραστηριότητες,2017,Μάιος,0,0,0,726,726
L,12,Διαχείριση ακίνητης περιουσίας,2017,Μάιος,0,0,9,222,231
M,13,"Επαγγελματικές, επιστημονικές και τεχνικές δραστηριότητες",2017,Μάιος,0,0,0,693,693
N,14,Διοικητικές και υποστηρικτικές δραστηριότητες,2017,Μάιος,0,0,8,415,423
O,15,Δημόσια διοίκηση και άμυνα. Υποχρεωτική κοινωνική ασφάλιση,2017,Μάιος,0,1,0,684,685
P,16,Εκπαίδευση,2017,Μάιος,0,0,0,396,396
Q,17,Δραστηριότητες σχετικές με την ανθρώπινη υγεία και την κοινωνική μέριμνα,2017,Μάιος,0,0,0,272,272
R,18,"Τέχνες, διασκέδαση και ψυχαγωγία",2017,Μάιος,0,0,4,296,300
S,19,Άλλες δραστηριότητες παροχής υπηρεσιών,2017,Μάιος,0,0,7,280,287
T,20,Δραστηριότητες νοικοκυριών ως εργοδοτών,2017,Μάιος,0,0,0,35,35
U,21,Δραστηριότητες ετερόδικων οργανισμών και φορέων,2017,Μάιος,0,0,0,15,15
N/A,22,Μη δηλωμένη οικονομική δραστηριότητα,2017,Μάιος,0,0,8,1036,1044
LIM,23,Λιμενεργάτες,2017,Μάιος,0,0,0,3,3
Σύνολο,Σύνολο,Σύνολο,2017,Μάιος,0,3,1133,12349,13485
A,1,"Γεωργία, δασοκομία και αλιεία",2017,Ιούνιος,0,0,1,104,105
B,2,Ορυχεία και λατομεία,2017,Ιούνιος,0,0,0,13,13
C,3,Μεταποίηση,2017,Ιούνιος,0,0,0,852,852
D,4,"Παροχή ηλεκτρικού ρεύματος, φυσικού αερίου, ατμού και κλιματισμού",2017,Ιούνιος,0,0,0,6,6
E,5,"Παροχή νερού, επεξεργασία λυμάτων, διαχείριση αποβλήτων και δραστηριότητες εξυγίανσης",2017,Ιούνιος,0,0,0,3,3
F,6,Κατασκευές,2017,Ιούνιος,0,0,4,634,638
G,7,Χονδρικό και λιανικό εμπόριο.  Επισκευή μηχανοκίνητων οχημάτων και μοτοσυκλετών,2017,Ιούνιος,0,0,8,2420,2428
H,8,Μεταφορά και αποθήκευση,2017,Ιούνιος,0,0,0,390,390
I,9,Δραστηριότητες υπηρεσιών παροχής καταλύματος και υπηρεσιών εστίασης,2017,Ιούνιος,0,1,294,1128,1423
J,10,Ενημέρωση και επικοινωνία,2017,Ιούνιος,0,0,0,341,341
K,11,Χρηματοπιστωτικές και ασφαλιστικές δραστηριότητες,2017,Ιούνιος,0,0,0,646,646
L,12,Διαχείριση ακίνητης περιουσίας,2017,Ιούνιος,0,0,7,179,186
M,13,"Επαγγελματικές, επιστημονικές και τεχνικές δραστηριότητες",2017,Ιούνιος,0,0,0,632,632
N,14,Διοικητικές και υποστηρικτικές δραστηριότητες,2017,Ιούνιος,0,0,0,296,296
O,15,Δημόσια διοίκηση και άμυνα. Υποχρεωτική κοινωνική ασφάλιση,2017,Ιούνιος,0,0,0,1058,1058
P,16,Εκπαίδευση,2017,Ιούνιος,0,0,0,1366,1366
Q,17,Δραστηριότητες σχετικές με την ανθρώπινη υγεία και την κοινωνική μέριμνα,2017,Ιούνιος,0,0,0,257,257
R,18,"Τέχνες, διασκέδαση και ψυχαγωγία",2017,Ιούνιος,0,0,2,234,236
S,19,Άλλες δραστηριότητες παροχής υπηρεσιών,2017,Ιούνιος,0,0,4,293,297
T,20,Δραστηριότητες νοικοκυριών ως εργοδοτών,2017,Ιούνιος,0,0,0,33,33
U,21,Δραστηριότητες ετερόδικων οργανισμών και φορέων,2017,Ιούνιος,0,0,0,17,17
N/A,22,Μη δηλωμένη οικονομική δραστηριότητα,2017,Ιούνιος,0,0,1,1066,1067
LIM,23,Λιμενεργάτες,2017,Ιούνιος,0,0,0,4,4
Σύνολο,Σύνολο,Σύνολο,2017,Ιούνιος,0,1,321,11972,12294
A,1,"Γεωργία, δασοκομία και αλιεία",2017,Ιούλιος,0,0,0,107,107
B,2,Ορυχεία και λατομεία,2017,Ιούλιος,0,0,0,12,12
C,3,Μεταποίηση,2017,Ιούλιος,0,0,0,851,851
D,4,"Παροχή ηλεκτρικού ρεύματος, φυσικού αερίου, ατμού και κλιματισμού",2017,Ιούλιος,0,0,0,6,6
E,5,"Παροχή νερού, επεξεργασία λυμάτων, διαχείριση αποβλήτων και δραστηριότητες εξυγίανσης",2017,Ιούλιος,0,0,0,4,4
F,6,Κατασκευές,2017,Ιούλιος,0,0,3,661,664
G,7,Χονδρικό και λιανικό εμπόριο.  Επισκευή μηχανοκίνητων οχημάτων και μοτοσυκλετών,2017,Ιούλιος,0,0,9,2446,2455
H,8,Μεταφορά και αποθήκευση,2017,Ιούλιος,0,0,0,393,393
I,9,Δραστηριότητες υπηρεσιών παροχής καταλύματος και υπηρεσιών εστίασης,2017,Ιούλιος,0,1,231,1093,1325
J,10,Ενημέρωση και επικοινωνία,2017,Ιούλιος,0,0,0,359,359
K,11,Χρηματοπιστωτικές και ασφαλιστικές δραστηριότητες,2017,Ιούλιος,0,0,0,596,596
L,12,Διαχείριση ακίνητης περιουσίας,2017,Ιούλιος,0,0,7,163,170
M,13,"Επαγγελματικές, επιστημονικές και τεχνικές δραστηριότητες",2017,Ιούλιος,0,0,0,656,656
N,14,Διοικητικές και υποστηρικτικές δραστηριότητες,2017,Ιούλιος,0,0,0,297,297
O,15,Δημόσια διοίκηση και άμυνα. Υποχρεωτική κοινωνική ασφάλιση,2017,Ιούλιος,0,0,0,1677,1677
P,16,Εκπαίδευση,2017,Ιούλιος,0,0,0,2341,2341
Q,17,Δραστηριότητες σχετικές με την ανθρώπινη υγεία και την κοινωνική μέριμνα,2017,Ιούλιος,0,0,1,284,285
R,18,"Τέχνες, διασκέδαση και ψυχαγωγία",2017,Ιούλιος,0,0,2,232,234
S,19,Άλλες δραστηριότητες παροχής υπηρεσιών,2017,Ιούλιος,0,0,4,385,389
T,20,Δραστηριότητες νοικοκυριών ως εργοδοτών,2017,Ιούλιος,0,0,0,31,31
U,21,Δραστηριότητες ετερόδικων οργανισμών και φορέων,2017,Ιούλιος,0,0,0,17,17
N/A,22,Μη δηλωμένη οικονομική δραστηριότητα,2017,Ιούλιος,0,0,0,1086,1086
LIM,23,Λιμενεργάτες,2017,Ιούλιος,0,0,0,5,5
Σύνολο,Σύνολο,Σύνολο,2017,Ιούλιος,0,1,257,13702,13960
A,1,"Γεωργία, δασοκομία και αλιεία",2017,Αύγουστος,0,0,0,99,99
B,2,Ορυχεία και λατομεία,2017,Αύγουστος,0,0,0,11,11
C,3,Μεταποίηση,2017,Αύγουστος,0,0,0,889,889
D,4,"Παροχή ηλεκτρικού ρεύματος, φυσικού αερίου, ατμού και κλιματισμού",2017,Αύγουστος,0,0,0,5,5
E,5,"Παροχή νερού, επεξεργασία λυμάτων, διαχείριση αποβλήτων και δραστηριότητες εξυγίανσης",2017,Αύγουστος,0,0,0,4,4
F,6,Κατασκευές,2017,Αύγουστος,0,0,2,670,672
G,7,Χονδρικό και λιανικό εμπόριο.  Επισκευή μηχανοκίνητων οχημάτων και μοτοσυκλετών,2017,Αύγουστος,0,0,8,2398,2406
H,8,Μεταφορά και αποθήκευση,2017,Αύγουστος,0,0,0,375,375
I,9,Δραστηριότητες υπηρεσιών παροχής καταλύματος και υπηρεσιών εστίασης,2017,Αύγουστος,0,1,195,1079,1275
J,10,Ενημέρωση και επικοινωνία,2017,Αύγουστος,0,0,0,341,341
K,11,Χρηματοπιστωτικές και ασφαλιστικές δραστηριότητες,2017,Αύγουστος,0,0,0,534,534
L,12,Διαχείριση ακίνητης περιουσίας,2017,Αύγουστος,0,0,2,93,95
M,13,"Επαγγελματικές, επιστημονικές και τεχνικές δραστηριότητες",2017,Αύγουστος,0,0,0,695,695
N,14,Διοικητικές και υποστηρικτικές δραστηριότητες,2017,Αύγουστος,0,0,0,290,290
O,15,Δημόσια διοίκηση και άμυνα. Υποχρεωτική κοινωνική ασφάλιση,2017,Αύγουστος,0,0,0,1739,1739
P,16,Εκπαίδευση,2017,Αύγουστος,0,0,0,2436,2436
Q,17,Δραστηριότητες σχετικές με την ανθρώπινη υγεία και την κοινωνική μέριμνα,2017,Αύγουστος,0,0,1,286,287
R,18,"Τέχνες, διασκέδαση και ψυχαγωγία",2017,Αύγουστος,0,0,3,216,219
S,19,Άλλες δραστηριότητες παροχής υπηρεσιών,2017,Αύγουστος,0,0,4,387,391
T,20,Δραστηριότητες νοικοκυριών ως εργοδοτών,2017,Αύγουστος,0,0,0,31,31
U,21,Δραστηριότητες ετερόδικων οργανισμών και φορέων,2017,Αύγουστος,0,0,0,16,16
N/A,22,Μη δηλωμένη οικονομική δραστηριότητα,2017,Αύγουστος,0,0,0,1123,1123
LIM,23,Λιμενεργάτες,2017,Αύγουστος,0,0,0,2,2
Σύνολο,Σύνολο,Σύνολο,2017,Αύγουστος,0,1,215,13719,13935
A,1,"Γεωργία, δασοκομία και αλιεία",2017,Σεπτέμβριος,0,0,0,96,96
B,2,Ορυχεία και λατομεία,2017,Σεπτέμβριος,0,0,0,11,11
C,3,Μεταποίηση,2017,Σεπτέμβριος,14,0,0,883,897
D,4,"Παροχή ηλεκτρικού ρεύματος, φυσικού αερίου, ατμού και κλιματισμού",2017,Σεπτέμβριος,0,0,0,3,3
E,5,"Παροχή νερού, επεξεργασία λυμάτων, διαχείριση αποβλήτων και δραστηριότητες εξυγίανσης",2017,Σεπτέμβριος,0,0,0,4,4
F,6,Κατασκευές,2017,Σεπτέμβριος,0,0,5,643,648
G,7,Χονδρικό και λιανικό εμπόριο.  Επισκευή μηχανοκίνητων οχημάτων και μοτοσυκλετών,2017,Σεπτέμβριος,0,0,7,2360,2367
H,8,Μεταφορά και αποθήκευση,2017,Σεπτέμβριος,0,0,0,371,371
I,9,Δραστηριότητες υπηρεσιών παροχής καταλύματος και υπηρεσιών εστίασης,2017,Σεπτέμβριος,0,0,189,1035,1224
J,10,Ενημέρωση και επικοινωνία,2017,Σεπτέμβριος,0,0,0,309,309
K,11,Χρηματοπιστωτικές και ασφαλιστικές δραστηριότητες,2017,Σεπτέμβριος,0,0,0,453,453
L,12,Διαχείριση ακίνητης περιουσίας,2017,Σεπτέμβριος,0,0,1,83,84
M,13,"Επαγγελματικές, επιστημονικές και τεχνικές δραστηριότητες",2017,Σεπτέμβριος,0,0,0,716,716
N,14,Διοικητικές και υποστηρικτικές δραστηριότητες,2017,Σεπτέμβριος,0,0,0,264,264
O,15,Δημόσια διοίκηση και άμυνα. Υποχρεωτική κοινωνική ασφάλιση,2017,Σεπτέμβριος,0,0,0,1188,1188
P,16,Εκπαίδευση,2017,Σεπτέμβριος,0,0,0,1466,1466
Q,17,Δραστηριότητες σχετικές με την ανθρώπινη υγεία και την κοινωνική μέριμνα,2017,Σεπτέμβριος,0,0,1,269,270
R,18,"Τέχνες, διασκέδαση και ψυχαγωγία",2017,Σεπτέμβριος,0,0,3,205,208
S,19,Άλλες δραστηριότητες παροχής υπηρεσιών,2017,Σεπτέμβριος,0,0,2,312,314
T,20,Δραστηριότητες νοικοκυριών ως εργοδοτών,2017,Σεπτέμβριος,0,0,0,30,30
U,21,Δραστηριότητες ετερόδικων οργανισμών και φορέων,2017,Σεπτέμβριος,0,0,0,12,12
N/A,22,Μη δηλωμένη οικονομική δραστηριότητα,2017,Σεπτέμβριος,0,0,1,1100,1101
LIM,23,Λιμενεργάτες,2017,Σεπτέμβριος,0,0,0,4,4
Σύνολο,Σύνολο,Σύνολο,2017,Σεπτέμβριος,14,0,209,11817,12040
A,1,"Γεωργία, δασοκομία και αλιεία",2017,Οκτώβριος,0,0,0,96,96
B,2,Ορυχεία και λατομεία,2017,Οκτώβριος,0,0,0,9,9
C,3,Μεταποίηση,2017,Οκτώβριος,22,0,0,878,900
D,4,"Παροχή ηλεκτρικού ρεύματος, φυσικού αερίου, ατμού και κλιματισμού",2017,Οκτώβριος,0,0,0,2,2
E,5,"Παροχή νερού, επεξεργασία λυμάτων, διαχείριση αποβλήτων και δραστηριότητες εξυγίανσης",2017,Οκτώβριος,0,0,0,4,4
F,6,Κατασκευές,2017,Οκτώβριος,0,0,4,583,587
G,7,Χονδρικό και λιανικό εμπόριο.  Επισκευή μηχανοκίνητων οχημάτων και μοτοσυκλετών,2017,Οκτώβριος,0,0,7,2294,2301
H,8,Μεταφορά και αποθήκευση,2017,Οκτώβριος,0,0,0,372,372
I,9,Δραστηριότητες υπηρεσιών παροχής καταλύματος και υπηρεσιών εστίασης,2017,Οκτώβριος,0,0,349,1110,1459
J,10,Ενημέρωση και επικοινωνία,2017,Οκτώβριος,0,0,0,288,288
K,11,Χρηματοπιστωτικές και ασφαλιστικές δραστηριότητες,2017,Οκτώβριος,0,0,0,418,418
L,12,Διαχείριση ακίνητης περιουσίας,2017,Οκτώβριος,0,0,1,90,91
M,13,"Επαγγελματικές, επιστημονικές και τεχνικές δραστηριότητες",2017,Οκτώβριος,0,0,0,698,698
N,14,Διοικητικές και υποστηρικτικές δραστηριότητες,2017,Οκτώβριος,0,0,0,290,290
O,15,Δημόσια διοίκηση και άμυνα. Υποχρεωτική κοινωνική ασφάλιση,2017,Οκτώβριος,0,0,0,568,568
P,16,Εκπαίδευση,2017,Οκτώβριος,0,0,0,528,528
Q,17,Δραστηριότητες σχετικές με την ανθρώπινη υγεία και την κοινωνική μέριμνα,2017,Οκτώβριος,0,0,1,245,246
R,18,"Τέχνες, διασκέδαση και ψυχαγωγία",2017,Οκτώβριος,0,0,0,191,191
S,19,Άλλες δραστηριότητες παροχής υπηρεσιών,2017,Οκτώβριος,0,0,9,238,247
T,20,Δραστηριότητες νοικοκυριών ως εργοδοτών,2017,Οκτώβριος,0,0,0,25,25
U,21,Δραστηριότητες ετερόδικων οργανισμών και φορέων,2017,Οκτώβριος,0,0,0,7,7
N/A,22,Μη δηλωμένη οικονομική δραστηριότητα,2017,Οκτώβριος,0,0,1,987,988
LIM,23,Λιμενεργάτες,2017,Οκτώβριος,0,0,0,1,1
Σύνολο,Σύνολο,Σύνολο,2017,Οκτώβριος,22,0,372,9922,10316
A,1,"Γεωργία, δασοκομία και αλιεία",2017,Νοέμβριος,0,0,0,70,70
B,2,Ορυχεία και λατομεία,2017,Νοέμβριος,0,0,0,10,10
C,3,Μεταποίηση,2017,Νοέμβριος,27,0,3,908,938
D,4,"Παροχή ηλεκτρικού ρεύματος, φυσικού αερίου, ατμού και κλιματισμού",2017,Νοέμβριος,0,0,0,2,2
E,5,"Παροχή νερού, επεξεργασία λυμάτων, διαχείριση αποβλήτων και δραστηριότητες εξυγίανσης",2017,Νοέμβριος,0,0,0,4,4
F,6,Κατασκευές,2017,Νοέμβριος,0,0,7,553,560
G,7,Χονδρικό και λιανικό εμπόριο.  Επισκευή μηχανοκίνητων οχημάτων και μοτοσυκλετών,2017,Νοέμβριος,0,157,39,2839,3035
H,8,Μεταφορά και αποθήκευση,2017,Νοέμβριος,0,20,12,788,820
I,9,Δραστηριότητες υπηρεσιών παροχής καταλύματος και υπηρεσιών εστίασης,2017,Νοέμβριος,0,1339,4471,2641,8451
J,10,Ενημέρωση και επικοινωνία,2017,Νοέμβριος,0,0,2,297,299
K,11,Χρηματοπιστωτικές και ασφαλιστικές δραστηριότητες,2017,Νοέμβριος,0,0,0,376,376
L,12,Διαχείριση ακίνητης περιουσίας,2017,Νοέμβριος,0,0,6,130,136
M,13,"Επαγγελματικές, επιστημονικές και τεχνικές δραστηριότητες",2017,Νοέμβριος,0,0,0,663,663
N,14,Διοικητικές και υποστηρικτικές δραστηριότητες,2017,Νοέμβριος,0,52,8,606,666
O,15,Δημόσια διοίκηση και άμυνα. Υποχρεωτική κοινωνική ασφάλιση,2017,Νοέμβριος,0,8,1,769,778
P,16,Εκπαίδευση,2017,Νοέμβριος,0,12,0,332,344
Q,17,Δραστηριότητες σχετικές με την ανθρώπινη υγεία και την κοινωνική μέριμνα,2017,Νοέμβριος,0,0,1,253,254
R,18,"Τέχνες, διασκέδαση και ψυχαγωγία",2017,Νοέμβριος,0,40,8,343,391
S,19,Άλλες δραστηριότητες παροχής υπηρεσιών,2017,Νοέμβριος,0,7,22,331,360
T,20,Δραστηριότητες νοικοκυριών ως εργοδοτών,2017,Νοέμβριος,0,0,0,22,22
U,21,Δραστηριότητες ετερόδικων οργανισμών και φορέων,2017,Νοέμβριος,0,0,0,6,6
N/A,22,Μη δηλωμένη οικονομική δραστηριότητα,2017,Νοέμβριος,0,0,5,877,882
LIM,23,Λιμενεργάτες,2017,Νοέμβριος,0,0,0,0,0
Σύνολο,Σύνολο,Σύνολο,2017,Νοέμβριος,27,1635,4585,12820,19067
A,1,"Γεωργία, δασοκομία και αλιεία",2017,Δεκέμβριος,0,0,0,68,68
B,2,Ορυχεία και λατομεία,2017,Δεκέμβριος,0,0,0,10,10
C,3,Μεταποίηση,2017,Δεκέμβριος,26,0,4,906,936
D,4,"Παροχή ηλεκτρικού ρεύματος, φυσικού αερίου, ατμού και κλιματισμού",2017,Δεκέμβριος,0,0,0,1,1
E,5,"Παροχή νερού, επεξεργασία λυμάτων, διαχείριση αποβλήτων και δραστηριότητες εξυγίανσης",2017,Δεκέμβριος,0,0,9,4,13
F,6,Κατασκευές,2017,Δεκέμβριος,0,0,51,563,614
G,7,Χονδρικό και λιανικό εμπόριο.  Επισκευή μηχανοκίνητων οχημάτων και μοτοσυκλετών,2017,Δεκέμβριος,0,217,12,2942,3171
H,8,Μεταφορά και αποθήκευση,2017,Δεκέμβριος,0,22,5765,961,6748
I,9,Δραστηριότητες υπηρεσιών παροχής καταλύματος και υπηρεσιών εστίασης,2017,Δεκέμβριος,0,2706,0,3052,5758
J,10,Ενημέρωση και επικοινωνία,2017,Δεκέμβριος,0,0,2,285,287
K,11,Χρηματοπιστωτικές και ασφαλιστικές δραστηριότητες,2017,Δεκέμβριος,0,0,0,374,374
L,12,Διαχείριση ακίνητης περιουσίας,2017,Δεκέμβριος,0,0,7,152,159
M,13,"Επαγγελματικές, επιστημονικές και τεχνικές δραστηριότητες",2017,Δεκέμβριος,0,0,0,656,656
N,14,Διοικητικές και υποστηρικτικές δραστηριότητες,2017,Δεκέμβριος,0,52,21,707,780
O,15,Δημόσια διοίκηση και άμυνα. Υποχρεωτική κοινωνική ασφάλιση,2017,Δεκέμβριος,0,14,5,1740,1759
P,16,Εκπαίδευση,2017,Δεκέμβριος,0,10,0,326,336
Q,17,Δραστηριότητες σχετικές με την ανθρώπινη υγεία και την κοινωνική μέριμνα,2017,Δεκέμβριος,0,0,1,255,256
R,18,"Τέχνες, διασκέδαση και ψυχαγωγία",2017,Δεκέμβριος,0,41,12,371,424
S,19,Άλλες δραστηριότητες παροχής υπηρεσιών,2017,Δεκέμβριος,0,15,28,386,429
T,20,Δραστηριότητες νοικοκυριών ως εργοδοτών,2017,Δεκέμβριος,0,0,0,25,25
U,21,Δραστηριότητες ετερόδικων οργανισμών και φορέων,2017,Δεκέμβριος,0,0,0,6,6
N/A,22,Μη δηλωμένη οικονομική δραστηριότητα,2017,Δεκέμβριος,0,6,10,840,856
LIM,23,Λιμενεργάτες,2017,Δεκέμβριος,0,0,0,0,0
Σύνολο,Σύνολο,Σύνολο,2017,Δεκέμβριος,26,3083,5927,14630,23666
